"Student_Name";"Test_Case_1 (10)";"Test_Case_2 (10)";"Code_1 (10)";"Code_2 (10)";"Code_3 (10)";"Code_4 (20)";"Code_5 (10)";"Total_Marks (80)";"Comments"
22AE10002;0;0;0;0;0;0;0;0;========= TEST CASES =========~~~~~~FAILED: Test Case 1: ~~INPUT:2 2 2 3~~~~2 3~~2 3~~~~1 2 3~~4 5 6~~Desired Output:~~~~Matrices before multiplication:~~Matrix A:~~2 3~~2 3~~Matrix B:~~1 2 3~~4 5 6~~Matrices after multiplication:~~Matrix A:~~2 3~~2 3~~Matrix B:~~1 2 3~~4 5 6~~Resultant Matrix:~~14 19 24~~14 19 24 ~~  Mark/s obtained: 0 out of 10~~~~~~Your output:~~Enter the number of student data you want to enter : Enter details of student 1: ~~Roll no.: Enter marks of three subjects separated by space: ~~Enter details of student 2: ~~Roll no.: Enter marks of three subjects separated by space: ~~---------Student Records-------------~~Sorted Student Records:~~~~Roll No.: 2~~Marks : 2.00  3.00  2.00  ~~Total : 7.00~~~~Roll No.: 3~~Marks : 2.00  3.00  1.00  ~~Total : 6.00~~~~~~~~FAILED: Test Case 2: ~~INPUT:2 3 2 3~~~~1 2 3~~1 1 1~~~~2 3 3~~1 1 1~~Desired Output:~~~~Matrices before multiplication:~~Matrix A:~~1 2 3~~1 1 1~~Matrix B:~~2 3 3~~1 1 1~~Error: Invalid matrix sizes for multiplication! ~~  Mark/s obtained: 0 out of 10~~~~~~Your output:~~Enter the number of student data you want to enter : Enter details of student 1: ~~Roll no.: Enter marks of three subjects separated by space: ~~Enter details of student 2: ~~Roll no.: Enter marks of three subjects separated by space: ~~---------Student Records-------------~~Sorted Student Records:~~~~Roll No.: 3~~Marks : 2.00  3.00  1.00  ~~Total : 6.00~~~~Roll No.: 2~~Marks : 3.00  1.00  1.00  ~~Total : 5.00~~~~~~~~========= CODE CASES =========~~~~~~FAILED: Code Case 1:~~Correct structure definition to store 2D matrix~~  Mark/s obtained: 0 out of 10~~~~~~FAILED: Code Case 2:~~Creation of matrix~~  Mark/s obtained: 0 out of 10~~~~~~FAILED: Code Case 3:~~Read and print of matrix~~  Mark/s obtained: 0 out of 10~~~~~~FAILED: Code Case 4:~~Matrix multiplication logic~~  Mark/s obtained: 0 out of 20~~~~~~FAILED: Code Case 5:~~Correct Resultant matrix~~  Mark/s obtained: 0 out of 10~~~~~~==============================~~~~########## TOTAL MARKS OBTAINED = 0/80 ###########
22AE10022;0;0;2;2;2;0;0;6;========= TEST CASES =========~~~~~~FAILED: Code didn't compile successfully~~  Mark/s obtained: 0 out of 20~~~~~~========= CODE CASES =========~~~~~~FAILED: Code Case 1:~~Correct structure definition to store 2D matrix~~  Mark/s obtained: 2 out of 10~~~~~~FAILED: Code Case 2:~~Creation of matrix~~  Mark/s obtained: 2 out of 10~~~~~~FAILED: Code Case 3:~~Read and print of matrix~~  Mark/s obtained: 2 out of 10~~~~~~FAILED: Code Case 4:~~Matrix multiplication logic~~  Mark/s obtained: 0 out of 20~~~~~~FAILED: Code Case 5:~~Correct Resultant matrix~~  Mark/s obtained: 0 out of 10~~~~~~==============================~~~~########## TOTAL MARKS OBTAINED = 6/80 ###########
22AE10042;3;2;1;1;5;0;0;12;========= TEST CASES =========~~~~~~FAILED: Test Case 1: ~~INPUT:2 2 2 3~~~~2 3~~2 3~~~~1 2 3~~4 5 6~~Desired Output:~~~~Matrices before multiplication:~~Matrix A:~~2 3~~2 3~~Matrix B:~~1 2 3~~4 5 6~~Matrices after multiplication:~~Matrix A:~~2 3~~2 3~~Matrix B:~~1 2 3~~4 5 6~~Resultant Matrix:~~14 19 24~~14 19 24 ~~  Mark/s obtained: 3 out of 10~~~~~~Your output:~~~~~~FAILED: Test Case 2: ~~INPUT:2 3 2 3~~~~1 2 3~~1 1 1~~~~2 3 3~~1 1 1~~Desired Output:~~~~Matrices before multiplication:~~Matrix A:~~1 2 3~~1 1 1~~Matrix B:~~2 3 3~~1 1 1~~Error: Invalid matrix sizes for multiplication! ~~  Mark/s obtained: 2 out of 10~~~~~~Your output:~~~~~~========= CODE CASES =========~~~~~~FAILED: Code Case 1:~~Correct structure definition to store 2D matrix~~  Mark/s obtained: 1 out of 10~~~~~~FAILED: Code Case 2:~~Creation of matrix~~  Mark/s obtained: 1 out of 10~~~~~~FAILED: Code Case 3:~~Read and print of matrix~~  Mark/s obtained: 5 out of 10~~~~~~FAILED: Code Case 4:~~Matrix multiplication logic~~  Mark/s obtained: 0 out of 20~~~~~~FAILED: Code Case 5:~~Correct Resultant matrix~~  Mark/s obtained: 0 out of 10~~~~~~==============================~~~~########## TOTAL MARKS OBTAINED = 12/80 ##########
22AE30015;0;0;0;0;0;0;0;0;========= TEST CASES =========~~~~~~FAILED: Code didn't compile successfully~~  Mark/s obtained: 0 out of 20~~~~~~========= CODE CASES =========~~~~~~FAILED: Code Case 1:~~Correct structure definition to store 2D matrix~~  Mark/s obtained: 0 out of 10~~~~~~FAILED: Code Case 2:~~Creation of matrix~~  Mark/s obtained: 0 out of 10~~~~~~FAILED: Code Case 3:~~Read and print of matrix~~  Mark/s obtained: 0 out of 10~~~~~~FAILED: Code Case 4:~~Matrix multiplication logic~~  Mark/s obtained: 0 out of 20~~~~~~FAILED: Code Case 5:~~Correct Resultant matrix~~  Mark/s obtained: 0 out of 10~~~~~~==============================~~~~########## TOTAL MARKS OBTAINED = 0/80 ###########
22AG10009;4;2;8;10;10;14;0;48;========= TEST CASES =========~~~~~~FAILED: Test Case 1: ~~INPUT:2 2 2 3~~~~2 3~~2 3~~~~1 2 3~~4 5 6~~Desired Output:~~~~Matrices before multiplication:~~Matrix A:~~2 3~~2 3~~Matrix B:~~1 2 3~~4 5 6~~Matrices after multiplication:~~Matrix A:~~2 3~~2 3~~Matrix B:~~1 2 3~~4 5 6~~Resultant Matrix:~~14 19 24~~14 19 24 ~~  Mark/s obtained: 4 out of 10~~~~~~Your output:~~~~~~FAILED: Test Case 2: ~~INPUT:2 3 2 3~~~~1 2 3~~1 1 1~~~~2 3 3~~1 1 1~~Desired Output:~~~~Matrices before multiplication:~~Matrix A:~~1 2 3~~1 1 1~~Matrix B:~~2 3 3~~1 1 1~~Error: Invalid matrix sizes for multiplication! ~~  Mark/s obtained: 2 out of 10~~~~~~Your output:~~~~~~========= CODE CASES =========~~~~~~FAILED: Code Case 1:~~Correct structure definition to store 2D matrix~~  Mark/s obtained: 8 out of 10~~~~~~PASSED: Code Case 2:~~Creation of matrix~~  Mark/s obtained: 10 out of 10~~~~~~PASSED: Code Case 3:~~Read and print of matrix~~  Mark/s obtained: 10 out of 10~~~~~~FAILED: Code Case 4:~~Matrix multiplication logic~~  Mark/s obtained: 14 out of 20~~~~~~FAILED: Code Case 5:~~Correct Resultant matrix~~  Mark/s obtained: 0 out of 10~~~~~~==============================~~~~########## TOTAL MARKS OBTAINED = 48/80 ##########
22AG10029;10;10;10;10;10;20;10;80;Good~~~~========= TEST CASES =========~~~~PASSED: All test cases - Marks : 20 out of 20~~~~========= CODE CASES =========~~~~~~PASSED: Code Case 1:~~Correct structure definition to store 2D matrix~~  Mark/s obtained: 10 out of 10~~~~~~PASSED: Code Case 2:~~Creation of matrix~~  Mark/s obtained: 10 out of 10~~~~~~PASSED: Code Case 3:~~Read and print of matrix~~  Mark/s obtained: 10 out of 10~~~~~~PASSED: Code Case 4:~~Matrix multiplication logic~~  Mark/s obtained: 20 out of 20~~~~~~PASSED: Code Case 5:~~Correct Resultant matrix~~  Mark/s obtained: 10 out of 10~~~~PASSED: All code cases - Marks : 60 out of 60~~~~==============================~~~~########## TOTAL MARKS OBTAINED = 80/80 ##########
22AG10049;0;0;0;0;0;0;0;0;A file was not submitted properly ~~Mark/s lost: 80 out of 80~~~~~~==============================~~~~########## TOTAL MARKS OBTAINED = 0/80 ###########
22AG30016;1;4;0;0;2;0;0;7;========= TEST CASES =========~~~~~~FAILED: Test Case 1: ~~INPUT:2 2 2 3~~~~2 3~~2 3~~~~1 2 3~~4 5 6~~Desired Output:~~~~Matrices before multiplication:~~Matrix A:~~2 3~~2 3~~Matrix B:~~1 2 3~~4 5 6~~Matrices after multiplication:~~Matrix A:~~2 3~~2 3~~Matrix B:~~1 2 3~~4 5 6~~Resultant Matrix:~~14 19 24~~14 19 24 ~~  Mark/s obtained: 1 out of 10~~~~~~Your output:~~enter number of rows of matrix A: enter number of columns of matrix A: enter values: enter number of rows of matrix B: enter number of columns of matrix B: enter values: matrices before multiplication: ~~23~~~~23~~~~123~~456~~~~~~FAILED: Test Case 2: ~~INPUT:2 3 2 3~~~~1 2 3~~1 1 1~~~~2 3 3~~1 1 1~~Desired Output:~~~~Matrices before multiplication:~~Matrix A:~~1 2 3~~1 1 1~~Matrix B:~~2 3 3~~1 1 1~~Error: Invalid matrix sizes for multiplication! ~~  Mark/s obtained: 4 out of 10~~~~~~Your output:~~enter number of rows of matrix A: enter number of columns of matrix A: enter values: enter number of rows of matrix B: enter number of columns of matrix B: enter values: matrices before multiplication: ~~231~~~~231~~~~2~~matrix multiplication not possible~~~~========= CODE CASES =========~~~~~~FAILED: Code Case 1:~~Correct structure definition to store 2D matrix~~  Mark/s obtained: 0 out of 10~~~~~~FAILED: Code Case 2:~~Creation of matrix~~  Mark/s obtained: 0 out of 10~~~~~~FAILED: Code Case 3:~~Read and print of matrix~~  Mark/s obtained: 2 out of 10~~~~~~FAILED: Code Case 4:~~Matrix multiplication logic~~  Mark/s obtained: 0 out of 20~~~~~~FAILED: Code Case 5:~~Correct Resultant matrix~~  Mark/s obtained: 0 out of 10~~~~~~==============================~~~~########## TOTAL MARKS OBTAINED = 7/80 ###########
22AG30036;0;0;0;0;0;0;0;0;A file was not submitted properly ~~Mark/s lost: 80 out of 80~~~~~~==============================~~~~########## TOTAL MARKS OBTAINED = 0/80 ###########
22BT10007;0;0;0;0;0;0;0;0;A file was not submitted properly ~~Mark/s lost: 80 out of 80~~~~~~==============================~~~~########## TOTAL MARKS OBTAINED = 0/80 ###########
22BT10027;2;2;0;3;2;6;2;17;========= TEST CASES =========~~~~~~FAILED: Test Case 1: ~~INPUT:2 2 2 3~~~~2 3~~2 3~~~~1 2 3~~4 5 6~~Desired Output:~~~~Matrices before multiplication:~~Matrix A:~~2 3~~2 3~~Matrix B:~~1 2 3~~4 5 6~~Matrices after multiplication:~~Matrix A:~~2 3~~2 3~~Matrix B:~~1 2 3~~4 5 6~~Resultant Matrix:~~14 19 24~~14 19 24 ~~  Mark/s obtained: 2 out of 10~~~~~~Your output:~~[ERROR: SEGMENTATION_FAULT or RUNTIMEOUT.~~It may be due one of the following:~~+ Waits for more user input than expected/defined in the question or~~+ Code throws a math exception during runtime or~~+ Runs into an infinite loop or~~or something else completely, we will never know...~~]~~~~FAILED: Test Case 2: ~~INPUT:2 3 2 3~~~~1 2 3~~1 1 1~~~~2 3 3~~1 1 1~~Desired Output:~~~~Matrices before multiplication:~~Matrix A:~~1 2 3~~1 1 1~~Matrix B:~~2 3 3~~1 1 1~~Error: Invalid matrix sizes for multiplication! ~~  Mark/s obtained: 2 out of 10~~~~~~Your output:~~[ERROR: SEGMENTATION_FAULT or RUNTIMEOUT.~~It may be due one of the following:~~+ Waits for more user input than expected/defined in the question or~~+ Code throws a math exception during runtime or~~+ Runs into an infinite loop or~~or something else completely, we will never know...~~]~~~~========= CODE CASES =========~~~~~~FAILED: Code Case 1:~~Correct structure definition to store 2D matrix~~  Mark/s obtained: 0 out of 10~~~~~~FAILED: Code Case 2:~~Creation of matrix~~  Mark/s obtained: 3 out of 10~~~~~~FAILED: Code Case 3:~~Read and print of matrix~~  Mark/s obtained: 2 out of 10~~~~~~FAILED: Code Case 4:~~Matrix multiplication logic~~  Mark/s obtained: 6 out of 20~~~~~~FAILED: Code Case 5:~~Correct Resultant matrix~~  Mark/s obtained: 2 out of 10~~~~~~==============================~~~~########## TOTAL MARKS OBTAINED = 17/80 ##########
22BT30010;0;0;0;0;0;0;0;0;========= TEST CASES =========~~~~~~FAILED: Test Case 1: ~~INPUT:2 2 2 3~~~~2 3~~2 3~~~~1 2 3~~4 5 6~~Desired Output:~~~~Matrices before multiplication:~~Matrix A:~~2 3~~2 3~~Matrix B:~~1 2 3~~4 5 6~~Matrices after multiplication:~~Matrix A:~~2 3~~2 3~~Matrix B:~~1 2 3~~4 5 6~~Resultant Matrix:~~14 19 24~~14 19 24 ~~  Mark/s obtained: 0 out of 10~~~~~~Your output:~~enter the no of rows~~~~FAILED: Test Case 2: ~~INPUT:2 3 2 3~~~~1 2 3~~1 1 1~~~~2 3 3~~1 1 1~~Desired Output:~~~~Matrices before multiplication:~~Matrix A:~~1 2 3~~1 1 1~~Matrix B:~~2 3 3~~1 1 1~~Error: Invalid matrix sizes for multiplication! ~~  Mark/s obtained: 0 out of 10~~~~~~Your output:~~enter the no of rows~~~~========= CODE CASES =========~~~~~~FAILED: Code Case 1:~~Correct structure definition to store 2D matrix~~  Mark/s obtained: 0 out of 10~~~~~~FAILED: Code Case 2:~~Creation of matrix~~  Mark/s obtained: 0 out of 10~~~~~~FAILED: Code Case 3:~~Read and print of matrix~~  Mark/s obtained: 0 out of 10~~~~~~FAILED: Code Case 4:~~Matrix multiplication logic~~  Mark/s obtained: 0 out of 20~~~~~~FAILED: Code Case 5:~~Correct Resultant matrix~~  Mark/s obtained: 0 out of 10~~~~~~==============================~~~~########## TOTAL MARKS OBTAINED = 0/80 ###########
22BT30030;0;0;0;0;0;0;0;0;A file was not submitted properly ~~Mark/s lost: 80 out of 80~~~~~~==============================~~~~########## TOTAL MARKS OBTAINED = 0/80 ###########
22CE10013;0;0;0;0;0;0;0;0;========= TEST CASES =========~~~~~~FAILED: Test Case 1: ~~INPUT:2 2 2 3~~~~2 3~~2 3~~~~1 2 3~~4 5 6~~Desired Output:~~~~Matrices before multiplication:~~Matrix A:~~2 3~~2 3~~Matrix B:~~1 2 3~~4 5 6~~Matrices after multiplication:~~Matrix A:~~2 3~~2 3~~Matrix B:~~1 2 3~~4 5 6~~Resultant Matrix:~~14 19 24~~14 19 24 ~~  Mark/s obtained: 0 out of 10~~~~~~Your output:~~enter the number of students :~~enter the data for students: enter the roll no of student 1 ~~ for student 1 enter the marks of subject 1 for student 1 enter the marks of subject 2 for student 1 enter the marks of subject 3 enter the roll no of student 2 ~~ for student 2 enter the marks of subject 1 for student 2 enter the marks of subject 2 for student 2 enter the marks of subject 3sorted student records: ~~roll no : 2 total marks: 7.000000 ~~ marks: 2.000000   ,  3.000000 ,   2.000000  ~~roll ...~~~~FAILED: Test Case 2: ~~INPUT:2 3 2 3~~~~1 2 3~~1 1 1~~~~2 3 3~~1 1 1~~Desired Output:~~~~Matrices before multiplication:~~Matrix A:~~1 2 3~~1 1 1~~Matrix B:~~2 3 3~~1 1 1~~Error: Invalid matrix sizes for multiplication! ~~  Mark/s obtained: 0 out of 10~~~~~~Your output:~~enter the number of students :~~enter the data for students: enter the roll no of student 1 ~~ for student 1 enter the marks of subject 1 for student 1 enter the marks of subject 2 for student 1 enter the marks of subject 3 enter the roll no of student 2 ~~ for student 2 enter the marks of subject 1 for student 2 enter the marks of subject 2 for student 2 enter the marks of subject 3sorted student records: ~~roll no : 3 total marks: 6.000000 ~~ marks: 2.000000   ,  3.000000 ,   1.000000  ~~roll ...~~~~========= CODE CASES =========~~~~~~FAILED: Code Case 1:~~Correct structure definition to store 2D matrix~~  Mark/s obtained: 0 out of 10~~~~~~FAILED: Code Case 2:~~Creation of matrix~~  Mark/s obtained: 0 out of 10~~~~~~FAILED: Code Case 3:~~Read and print of matrix~~  Mark/s obtained: 0 out of 10~~~~~~FAILED: Code Case 4:~~Matrix multiplication logic~~  Mark/s obtained: 0 out of 20~~~~~~FAILED: Code Case 5:~~Correct Resultant matrix~~  Mark/s obtained: 0 out of 10~~~~~~==============================~~~~########## TOTAL MARKS OBTAINED = 0/80 ###########
22CE10033;0;0;0;0;0;0;0;0;A file was not submitted properly ~~Mark/s lost: 80 out of 80~~~~~~==============================~~~~########## TOTAL MARKS OBTAINED = 0/80 ###########
22CE10073;0;0;0;0;0;0;0;0;========= TEST CASES =========~~~~~~FAILED: Code didn't compile successfully~~  Mark/s obtained: 0 out of 20~~~~~~========= CODE CASES =========~~~~~~FAILED: Code Case 1:~~Correct structure definition to store 2D matrix~~  Mark/s obtained: 0 out of 10~~~~~~FAILED: Code Case 2:~~Creation of matrix~~  Mark/s obtained: 0 out of 10~~~~~~FAILED: Code Case 3:~~Read and print of matrix~~  Mark/s obtained: 0 out of 10~~~~~~FAILED: Code Case 4:~~Matrix multiplication logic~~  Mark/s obtained: 0 out of 20~~~~~~FAILED: Code Case 5:~~Correct Resultant matrix~~  Mark/s obtained: 0 out of 10~~~~~~==============================~~~~########## TOTAL MARKS OBTAINED = 0/80 ###########
22CE30004;0;0;0;0;0;0;0;0;========= TEST CASES =========~~~~~~FAILED: Code didn't compile successfully~~  Mark/s obtained: 0 out of 20~~~~~~========= CODE CASES =========~~~~~~FAILED: Code Case 1:~~Correct structure definition to store 2D matrix~~  Mark/s obtained: 0 out of 10~~~~~~FAILED: Code Case 2:~~Creation of matrix~~  Mark/s obtained: 0 out of 10~~~~~~FAILED: Code Case 3:~~Read and print of matrix~~  Mark/s obtained: 0 out of 10~~~~~~FAILED: Code Case 4:~~Matrix multiplication logic~~  Mark/s obtained: 0 out of 20~~~~~~FAILED: Code Case 5:~~Correct Resultant matrix~~  Mark/s obtained: 0 out of 10~~~~~~==============================~~~~########## TOTAL MARKS OBTAINED = 0/80 ###########
22CE30024;0;0;0;0;0;0;0;0;========= TEST CASES =========~~~~~~FAILED: Code didn't compile successfully~~  Mark/s obtained: 0 out of 20~~~~~~========= CODE CASES =========~~~~~~FAILED: Code Case 1:~~Correct structure definition to store 2D matrix~~  Mark/s obtained: 0 out of 10~~~~~~FAILED: Code Case 2:~~Creation of matrix~~  Mark/s obtained: 0 out of 10~~~~~~FAILED: Code Case 3:~~Read and print of matrix~~  Mark/s obtained: 0 out of 10~~~~~~FAILED: Code Case 4:~~Matrix multiplication logic~~  Mark/s obtained: 0 out of 20~~~~~~FAILED: Code Case 5:~~Correct Resultant matrix~~  Mark/s obtained: 0 out of 10~~~~~~==============================~~~~########## TOTAL MARKS OBTAINED = 0/80 ###########
22CH10012;10;10;0;6;10;15;10;61;========= TEST CASES =========~~~~PASSED: All test cases - Marks : 20 out of 20~~~~========= CODE CASES =========~~~~~~FAILED: Code Case 1:~~Correct structure definition to store 2D matrix~~  Mark/s obtained: 0 out of 10~~~~~~FAILED: Code Case 2:~~Creation of matrix~~  Mark/s obtained: 6 out of 10~~~~~~PASSED: Code Case 3:~~Read and print of matrix~~  Mark/s obtained: 10 out of 10~~~~~~FAILED: Code Case 4:~~Matrix multiplication logic~~  Mark/s obtained: 15 out of 20~~~~~~PASSED: Code Case 5:~~Correct Resultant matrix~~  Mark/s obtained: 10 out of 10~~~~~~==============================~~~~########## TOTAL MARKS OBTAINED = 61/80 ##########
22CH10032;0;0;0;0;0;0;0;0;========= TEST CASES =========~~~~~~FAILED: Test Case 1: ~~INPUT:2 2 2 3~~~~2 3~~2 3~~~~1 2 3~~4 5 6~~Desired Output:~~~~Matrices before multiplication:~~Matrix A:~~2 3~~2 3~~Matrix B:~~1 2 3~~4 5 6~~Matrices after multiplication:~~Matrix A:~~2 3~~2 3~~Matrix B:~~1 2 3~~4 5 6~~Resultant Matrix:~~14 19 24~~14 19 24 ~~  Mark/s obtained: 0 out of 10~~~~~~Your output:~~~~Student Records:~~<Print in the order read>~~~~Sorted Student Records:~~Student Records:~~Roll No: 2~~Marks: 2.00 3.00 2.00~~Total: 7.00~~Roll No: 3~~Marks: 2.00 3.00 1.00~~Total: 6.00~~~~~~FAILED: Test Case 2: ~~INPUT:2 3 2 3~~~~1 2 3~~1 1 1~~~~2 3 3~~1 1 1~~Desired Output:~~~~Matrices before multiplication:~~Matrix A:~~1 2 3~~1 1 1~~Matrix B:~~2 3 3~~1 1 1~~Error: Invalid matrix sizes for multiplication! ~~  Mark/s obtained: 0 out of 10~~~~~~Your output:~~~~Student Records:~~<Print in the order read>~~~~Sorted Student Records:~~Student Records:~~Roll No: 3~~Marks: 2.00 3.00 1.00~~Total: 6.00~~Roll No: 2~~Marks: 3.00 1.00 1.00~~Total: 5.00~~~~~~========= CODE CASES =========~~~~~~FAILED: Code Case 1:~~Correct structure definition to store 2D matrix~~  Mark/s obtained: 0 out of 10~~~~~~FAILED: Code Case 2:~~Creation of matrix~~  Mark/s obtained: 0 out of 10~~~~~~FAILED: Code Case 3:~~Read and print of matrix~~  Mark/s obtained: 0 out of 10~~~~~~FAILED: Code Case 4:~~Matrix multiplication logic~~  Mark/s obtained: 0 out of 20~~~~~~FAILED: Code Case 5:~~Correct Resultant matrix~~  Mark/s obtained: 0 out of 10~~~~~~==============================~~~~########## TOTAL MARKS OBTAINED = 0/80 ###########
22CH10052;10;10;10;10;10;20;10;80;Great Job~~~~========= TEST CASES =========~~~~PASSED: All test cases - Marks : 20 out of 20~~~~========= CODE CASES =========~~~~~~PASSED: Code Case 1:~~Correct structure definition to store 2D matrix~~  Mark/s obtained: 10 out of 10~~~~~~PASSED: Code Case 2:~~Creation of matrix~~  Mark/s obtained: 10 out of 10~~~~~~PASSED: Code Case 3:~~Read and print of matrix~~  Mark/s obtained: 10 out of 10~~~~~~PASSED: Code Case 4:~~Matrix multiplication logic~~  Mark/s obtained: 20 out of 20~~~~~~PASSED: Code Case 5:~~Correct Resultant matrix~~  Mark/s obtained: 10 out of 10~~~~PASSED: All code cases - Marks : 60 out of 60~~~~==============================~~~~########## TOTAL MARKS OBTAINED = 80/80 ##########
22CH10072;0;0;0;0;0;0;0;0;A file was not submitted properly ~~Mark/s lost: 80 out of 80~~~~~~==============================~~~~########## TOTAL MARKS OBTAINED = 0/80 ###########
22CH30013;0;0;4;6;7;7;0;24;========= TEST CASES =========~~~~~~FAILED: Code didn't compile successfully~~  Mark/s obtained: 0 out of 20~~~~~~========= CODE CASES =========~~~~~~FAILED: Code Case 1:~~Correct structure definition to store 2D matrix~~  Mark/s obtained: 4 out of 10~~~~~~FAILED: Code Case 2:~~Creation of matrix~~  Mark/s obtained: 6 out of 10~~~~~~FAILED: Code Case 3:~~Read and print of matrix~~  Mark/s obtained: 7 out of 10~~~~~~FAILED: Code Case 4:~~Matrix multiplication logic~~  Mark/s obtained: 7 out of 20~~~~~~FAILED: Code Case 5:~~Correct Resultant matrix~~  Mark/s obtained: 0 out of 10~~~~~~==============================~~~~########## TOTAL MARKS OBTAINED = 24/80 ##########
22CH30033;0;0;0;0;0;0;0;0;A file was not submitted properly ~~Mark/s lost: 80 out of 80~~~~~~==============================~~~~########## TOTAL MARKS OBTAINED = 0/80 ###########
22CS10017;0;0;0;0;0;0;0;0;========= TEST CASES =========~~~~~~FAILED: Test Case 1: ~~INPUT:2 2 2 3~~~~2 3~~2 3~~~~1 2 3~~4 5 6~~Desired Output:~~~~Matrices before multiplication:~~Matrix A:~~2 3~~2 3~~Matrix B:~~1 2 3~~4 5 6~~Matrices after multiplication:~~Matrix A:~~2 3~~2 3~~Matrix B:~~1 2 3~~4 5 6~~Resultant Matrix:~~14 19 24~~14 19 24 ~~  Mark/s obtained: 0 out of 10~~~~~~Your output:~~~~ enter the rows matrix a :  ~~ enter the columns of matrix a :  ~~ enter the rows matrix b :  ~~ enter the columns of matrix a :  ~~~~FAILED: Test Case 2: ~~INPUT:2 3 2 3~~~~1 2 3~~1 1 1~~~~2 3 3~~1 1 1~~Desired Output:~~~~Matrices before multiplication:~~Matrix A:~~1 2 3~~1 1 1~~Matrix B:~~2 3 3~~1 1 1~~Error: Invalid matrix sizes for multiplication! ~~  Mark/s obtained: 0 out of 10~~~~~~Your output:~~~~ enter the rows matrix a :  ~~ enter the columns of matrix a :  ~~ enter the rows matrix b :  ~~ enter the columns of matrix a :  ~~~~========= CODE CASES =========~~~~~~FAILED: Code Case 1:~~Correct structure definition to store 2D matrix~~  Mark/s obtained: 0 out of 10~~~~~~FAILED: Code Case 2:~~Creation of matrix~~  Mark/s obtained: 0 out of 10~~~~~~FAILED: Code Case 3:~~Read and print of matrix~~  Mark/s obtained: 0 out of 10~~~~~~FAILED: Code Case 4:~~Matrix multiplication logic~~  Mark/s obtained: 0 out of 20~~~~~~FAILED: Code Case 5:~~Correct Resultant matrix~~  Mark/s obtained: 0 out of 10~~~~~~==============================~~~~########## TOTAL MARKS OBTAINED = 0/80 ###########
22CS10037;3;0;0;3;3;4;0;13;========= TEST CASES =========~~~~~~FAILED: Test Case 1: ~~INPUT:2 2 2 3~~~~2 3~~2 3~~~~1 2 3~~4 5 6~~Desired Output:~~~~Matrices before multiplication:~~Matrix A:~~2 3~~2 3~~Matrix B:~~1 2 3~~4 5 6~~Matrices after multiplication:~~Matrix A:~~2 3~~2 3~~Matrix B:~~1 2 3~~4 5 6~~Resultant Matrix:~~14 19 24~~14 19 24 ~~  Mark/s obtained: 3 out of 10~~~~~~Your output:~~enter the rows of matrix,A:enter the coloumns of matrix,A:enter the rows of matrix,Benter the columns of ,matrix ,Benter the values of matrix Aenter the values of matrix Bthe matrix A before multiplication:~~2 3 ~~2 3 ~~the matrix B before multiplication:~~1 2 3 ~~4 5 6 ~~the resultant matrix is:~~8257886 19 8257896 ~~8257886 19 8257896 ~~the matrix A after multiplication:~~2 3 ~~2 3 ~~the matrix B after multiplication:123~~456~~~~~~FAILED: Test Case 2: ~~INPUT:2 3 2 3~~~~1 2 3~~1 1 1~~~~2 3 3~~1 1 1~~Desired Output:~~~~Matrices before multiplication:~~Matrix A:~~1 2 3~~1 1 1~~Matrix B:~~2 3 3~~1 1 1~~Error: Invalid matrix sizes for multiplication! ~~  Mark/s obtained: 0 out of 10~~~~~~Your output:~~enter the rows of matrix,A:enter the coloumns of matrix,A:enter the rows of matrix,Benter the columns of ,matrix ,Benter the values of matrix Aenter the values of matrix Bthe matrix A before multiplication:~~1 2 3 ~~1 1 1 ~~the matrix B before multiplication:~~2 3 3 ~~1 1 1 ~~invalid sizes for multiplicationthe matrix A after multiplication:~~1 2 3 ~~1 1 1 ~~the matrix B after multiplication:233~~111~~~~~~========= CODE CASES =========~~~~~~FAILED: Code Case 1:~~Correct structure definition to store 2D matrix~~  Mark/s obtained: 0 out of 10~~~~~~FAILED: Code Case 2:~~Creation of matrix~~  Mark/s obtained: 3 out of 10~~~~~~FAILED: Code Case 3:~~Read and print of matrix~~  Mark/s obtained: 3 out of 10~~~~~~FAILED: Code Case 4:~~Matrix multiplication logic~~  Mark/s obtained: 4 out of 20~~~~~~FAILED: Code Case 5:~~Correct Resultant matrix~~  Mark/s obtained: 0 out of 10~~~~~~==============================~~~~########## TOTAL MARKS OBTAINED = 13/80 ##########
22CS10057;3;3;2;4;10;10;3;35;========= TEST CASES =========~~~~~~FAILED: Test Case 1: ~~INPUT:2 2 2 3~~~~2 3~~2 3~~~~1 2 3~~4 5 6~~Desired Output:~~~~Matrices before multiplication:~~Matrix A:~~2 3~~2 3~~Matrix B:~~1 2 3~~4 5 6~~Matrices after multiplication:~~Matrix A:~~2 3~~2 3~~Matrix B:~~1 2 3~~4 5 6~~Resultant Matrix:~~14 19 24~~14 19 24 ~~  Mark/s obtained: 3 out of 10~~~~~~Your output:~~[ERROR: SEGMENTATION_FAULT or RUNTIMEOUT.~~It may be due one of the following:~~+ Waits for more user input than expected/defined in the question or~~+ Code throws a math exception during runtime or~~+ Runs into an infinite loop or~~or something else completely, we will never know...~~]~~~~FAILED: Test Case 2: ~~INPUT:2 3 2 3~~~~1 2 3~~1 1 1~~~~2 3 3~~1 1 1~~Desired Output:~~~~Matrices before multiplication:~~Matrix A:~~1 2 3~~1 1 1~~Matrix B:~~2 3 3~~1 1 1~~Error: Invalid matrix sizes for multiplication! ~~  Mark/s obtained: 3 out of 10~~~~~~Your output:~~[ERROR: SEGMENTATION_FAULT or RUNTIMEOUT.~~It may be due one of the following:~~+ Waits for more user input than expected/defined in the question or~~+ Code throws a math exception during runtime or~~+ Runs into an infinite loop or~~or something else completely, we will never know...~~]~~~~========= CODE CASES =========~~~~~~FAILED: Code Case 1:~~Correct structure definition to store 2D matrix~~  Mark/s obtained: 2 out of 10~~~~~~FAILED: Code Case 2:~~Creation of matrix~~  Mark/s obtained: 4 out of 10~~~~~~PASSED: Code Case 3:~~Read and print of matrix~~  Mark/s obtained: 10 out of 10~~~~~~FAILED: Code Case 4:~~Matrix multiplication logic~~  Mark/s obtained: 10 out of 20~~~~~~FAILED: Code Case 5:~~Correct Resultant matrix~~  Mark/s obtained: 3 out of 10~~~~~~==============================~~~~########## TOTAL MARKS OBTAINED = 35/80 ##########
22CS10077;0;0;0;0;0;0;0;0;A file was not submitted properly ~~Mark/s lost: 80 out of 80~~~~~~==============================~~~~########## TOTAL MARKS OBTAINED = 0/80 ###########
22CS30016;10;10;9;10;10;20;10;79;========= TEST CASES =========~~~~PASSED: All test cases - Marks : 20 out of 20~~~~========= CODE CASES =========~~~~~~FAILED: Code Case 1:~~Correct structure definition to store 2D matrix~~  Mark/s obtained: 9 out of 10~~~~~~PASSED: Code Case 2:~~Creation of matrix~~  Mark/s obtained: 10 out of 10~~~~~~PASSED: Code Case 3:~~Read and print of matrix~~  Mark/s obtained: 10 out of 10~~~~~~PASSED: Code Case 4:~~Matrix multiplication logic~~  Mark/s obtained: 20 out of 20~~~~~~PASSED: Code Case 5:~~Correct Resultant matrix~~  Mark/s obtained: 10 out of 10~~~~~~==============================~~~~########## TOTAL MARKS OBTAINED = 79/80 ##########
22CS30036;10;10;9;10;10;20;10;79;========= TEST CASES =========~~~~PASSED: All test cases - Marks : 20 out of 20~~~~========= CODE CASES =========~~~~~~FAILED: Code Case 1:~~Correct structure definition to store 2D matrix~~  Mark/s obtained: 9 out of 10~~~~~~PASSED: Code Case 2:~~Creation of matrix~~  Mark/s obtained: 10 out of 10~~~~~~PASSED: Code Case 3:~~Read and print of matrix~~  Mark/s obtained: 10 out of 10~~~~~~PASSED: Code Case 4:~~Matrix multiplication logic~~  Mark/s obtained: 20 out of 20~~~~~~PASSED: Code Case 5:~~Correct Resultant matrix~~  Mark/s obtained: 10 out of 10~~~~~~==============================~~~~########## TOTAL MARKS OBTAINED = 79/80 ##########
22CS30056;10;10;9;10;10;20;10;79;========= TEST CASES =========~~~~PASSED: All test cases - Marks : 20 out of 20~~~~========= CODE CASES =========~~~~~~FAILED: Code Case 1:~~Correct structure definition to store 2D matrix~~  Mark/s obtained: 9 out of 10~~~~~~PASSED: Code Case 2:~~Creation of matrix~~  Mark/s obtained: 10 out of 10~~~~~~PASSED: Code Case 3:~~Read and print of matrix~~  Mark/s obtained: 10 out of 10~~~~~~PASSED: Code Case 4:~~Matrix multiplication logic~~  Mark/s obtained: 20 out of 20~~~~~~PASSED: Code Case 5:~~Correct Resultant matrix~~  Mark/s obtained: 10 out of 10~~~~~~==============================~~~~########## TOTAL MARKS OBTAINED = 79/80 ##########
22CY10036;3;3;0;2;2;0;0;10;========= TEST CASES =========~~~~~~FAILED: Test Case 1: ~~INPUT:2 2 2 3~~~~2 3~~2 3~~~~1 2 3~~4 5 6~~Desired Output:~~~~Matrices before multiplication:~~Matrix A:~~2 3~~2 3~~Matrix B:~~1 2 3~~4 5 6~~Matrices after multiplication:~~Matrix A:~~2 3~~2 3~~Matrix B:~~1 2 3~~4 5 6~~Resultant Matrix:~~14 19 24~~14 19 24 ~~  Mark/s obtained: 3 out of 10~~~~~~Your output:~~enter the no. of rows for matrix A : ~~enter the no. of columns for matrix A : ~~enter the no. of rows for matrix B: ~~enter the no. of columns for matrix B : ~~enter elements of A~~enter elements of B~~matrix A :~~1 2 ~~4 5 ~~matrix B:~~1 2 4 ~~4 5 6 ~~~~~~FAILED: Test Case 2: ~~INPUT:2 3 2 3~~~~1 2 3~~1 1 1~~~~2 3 3~~1 1 1~~Desired Output:~~~~Matrices before multiplication:~~Matrix A:~~1 2 3~~1 1 1~~Matrix B:~~2 3 3~~1 1 1~~Error: Invalid matrix sizes for multiplication! ~~  Mark/s obtained: 3 out of 10~~~~~~Your output:~~enter the no. of rows for matrix A : ~~enter the no. of columns for matrix A : ~~enter the no. of rows for matrix B: ~~enter the no. of columns for matrix B : ~~enter elements of A~~enter elements of B~~matrix A :~~2 3 3 ~~1 1 1 ~~matrix B:~~2 3 3 ~~1 1 1 ~~6421744 0 3 ~~~~~~========= CODE CASES =========~~~~~~FAILED: Code Case 1:~~Correct structure definition to store 2D matrix~~  Mark/s obtained: 0 out of 10~~~~~~FAILED: Code Case 2:~~Creation of matrix~~  Mark/s obtained: 2 out of 10~~~~~~FAILED: Code Case 3:~~Read and print of matrix~~  Mark/s obtained: 2 out of 10~~~~~~FAILED: Code Case 4:~~Matrix multiplication logic~~  Mark/s obtained: 0 out of 20~~~~~~FAILED: Code Case 5:~~Correct Resultant matrix~~  Mark/s obtained: 0 out of 10~~~~~~==============================~~~~########## TOTAL MARKS OBTAINED = 10/80 ##########
22EC10007;0;0;0;0;0;0;0;0;A file was not submitted properly ~~Mark/s lost: 80 out of 80~~~~~~==============================~~~~########## TOTAL MARKS OBTAINED = 0/80 ###########
22EC10027;0;0;0;0;0;0;0;0;========= TEST CASES =========~~~~~~FAILED: Code didn't compile successfully~~  Mark/s obtained: 0 out of 20~~~~~~========= CODE CASES =========~~~~~~FAILED: Code Case 1:~~Correct structure definition to store 2D matrix~~  Mark/s obtained: 0 out of 10~~~~~~FAILED: Code Case 2:~~Creation of matrix~~  Mark/s obtained: 0 out of 10~~~~~~FAILED: Code Case 3:~~Read and print of matrix~~  Mark/s obtained: 0 out of 10~~~~~~FAILED: Code Case 4:~~Matrix multiplication logic~~  Mark/s obtained: 0 out of 20~~~~~~FAILED: Code Case 5:~~Correct Resultant matrix~~  Mark/s obtained: 0 out of 10~~~~~~==============================~~~~########## TOTAL MARKS OBTAINED = 0/80 ###########
22EC10067;0;0;0;0;0;0;0;0;A file was not submitted properly ~~Mark/s lost: 80 out of 80~~~~~~==============================~~~~########## TOTAL MARKS OBTAINED = 0/80 ###########
22EC10087;10;10;10;10;10;20;10;80;Good work~~~~========= TEST CASES =========~~~~PASSED: All test cases - Marks : 20 out of 20~~~~========= CODE CASES =========~~~~~~PASSED: Code Case 1:~~Correct structure definition to store 2D matrix~~  Mark/s obtained: 10 out of 10~~~~~~PASSED: Code Case 2:~~Creation of matrix~~  Mark/s obtained: 10 out of 10~~~~~~PASSED: Code Case 3:~~Read and print of matrix~~  Mark/s obtained: 10 out of 10~~~~~~PASSED: Code Case 4:~~Matrix multiplication logic~~  Mark/s obtained: 20 out of 20~~~~~~PASSED: Code Case 5:~~Correct Resultant matrix~~  Mark/s obtained: 10 out of 10~~~~PASSED: All code cases - Marks : 60 out of 60~~~~==============================~~~~########## TOTAL MARKS OBTAINED = 80/80 ##########
22EC30015;10;10;10;10;10;20;10;80;Keep up the good work~~~~========= TEST CASES =========~~~~PASSED: All test cases - Marks : 20 out of 20~~~~========= CODE CASES =========~~~~~~PASSED: Code Case 1:~~Correct structure definition to store 2D matrix~~  Mark/s obtained: 10 out of 10~~~~~~PASSED: Code Case 2:~~Creation of matrix~~  Mark/s obtained: 10 out of 10~~~~~~PASSED: Code Case 3:~~Read and print of matrix~~  Mark/s obtained: 10 out of 10~~~~~~PASSED: Code Case 4:~~Matrix multiplication logic~~  Mark/s obtained: 20 out of 20~~~~~~PASSED: Code Case 5:~~Correct Resultant matrix~~  Mark/s obtained: 10 out of 10~~~~PASSED: All code cases - Marks : 60 out of 60~~~~==============================~~~~########## TOTAL MARKS OBTAINED = 80/80 ##########
22EC30035;10;10;10;10;10;20;10;80;Good~~~~========= TEST CASES =========~~~~PASSED: All test cases - Marks : 20 out of 20~~~~========= CODE CASES =========~~~~~~PASSED: Code Case 1:~~Correct structure definition to store 2D matrix~~  Mark/s obtained: 10 out of 10~~~~~~PASSED: Code Case 2:~~Creation of matrix~~  Mark/s obtained: 10 out of 10~~~~~~PASSED: Code Case 3:~~Read and print of matrix~~  Mark/s obtained: 10 out of 10~~~~~~PASSED: Code Case 4:~~Matrix multiplication logic~~  Mark/s obtained: 20 out of 20~~~~~~PASSED: Code Case 5:~~Correct Resultant matrix~~  Mark/s obtained: 10 out of 10~~~~PASSED: All code cases - Marks : 60 out of 60~~~~==============================~~~~########## TOTAL MARKS OBTAINED = 80/80 ##########
22EC30055;10;10;10;10;10;20;10;80;Nice work~~~~========= TEST CASES =========~~~~PASSED: All test cases - Marks : 20 out of 20~~~~========= CODE CASES =========~~~~~~PASSED: Code Case 1:~~Correct structure definition to store 2D matrix~~  Mark/s obtained: 10 out of 10~~~~~~PASSED: Code Case 2:~~Creation of matrix~~  Mark/s obtained: 10 out of 10~~~~~~PASSED: Code Case 3:~~Read and print of matrix~~  Mark/s obtained: 10 out of 10~~~~~~PASSED: Code Case 4:~~Matrix multiplication logic~~  Mark/s obtained: 20 out of 20~~~~~~PASSED: Code Case 5:~~Correct Resultant matrix~~  Mark/s obtained: 10 out of 10~~~~PASSED: All code cases - Marks : 60 out of 60~~~~==============================~~~~########## TOTAL MARKS OBTAINED = 80/80 ##########
22EE10016;0;0;0;2;2;0;0;4;========= TEST CASES =========~~~~~~FAILED: Code didn't compile successfully~~  Mark/s obtained: 0 out of 20~~~~~~========= CODE CASES =========~~~~~~FAILED: Code Case 1:~~Correct structure definition to store 2D matrix~~  Mark/s obtained: 0 out of 10~~~~~~FAILED: Code Case 2:~~Creation of matrix~~  Mark/s obtained: 2 out of 10~~~~~~FAILED: Code Case 3:~~Read and print of matrix~~  Mark/s obtained: 2 out of 10~~~~~~FAILED: Code Case 4:~~Matrix multiplication logic~~  Mark/s obtained: 0 out of 20~~~~~~FAILED: Code Case 5:~~Correct Resultant matrix~~  Mark/s obtained: 0 out of 10~~~~~~==============================~~~~########## TOTAL MARKS OBTAINED = 4/80 ###########
22EE10036;0;0;0;0;0;0;0;0;A file was not submitted properly ~~Mark/s lost: 80 out of 80~~~~~~==============================~~~~########## TOTAL MARKS OBTAINED = 0/80 ###########
22EE10056;10;10;5;10;10;20;10;75;========= TEST CASES =========~~~~PASSED: All test cases - Marks : 20 out of 20~~~~========= CODE CASES =========~~~~~~FAILED: Code Case 1:~~Correct structure definition to store 2D matrix~~  Mark/s obtained: 5 out of 10~~~~~~PASSED: Code Case 2:~~Creation of matrix~~  Mark/s obtained: 10 out of 10~~~~~~PASSED: Code Case 3:~~Read and print of matrix~~  Mark/s obtained: 10 out of 10~~~~~~PASSED: Code Case 4:~~Matrix multiplication logic~~  Mark/s obtained: 20 out of 20~~~~~~PASSED: Code Case 5:~~Correct Resultant matrix~~  Mark/s obtained: 10 out of 10~~~~~~==============================~~~~########## TOTAL MARKS OBTAINED = 75/80 ##########
22EE10076;0;0;0;0;0;0;0;0;A file was not submitted properly ~~Mark/s lost: 80 out of 80~~~~~~==============================~~~~########## TOTAL MARKS OBTAINED = 0/80 ###########
22EE30015;3;3;3;3;4;15;0;31;========= TEST CASES =========~~~~~~FAILED: Test Case 1: ~~INPUT:2 2 2 3~~~~2 3~~2 3~~~~1 2 3~~4 5 6~~Desired Output:~~~~Matrices before multiplication:~~Matrix A:~~2 3~~2 3~~Matrix B:~~1 2 3~~4 5 6~~Matrices after multiplication:~~Matrix A:~~2 3~~2 3~~Matrix B:~~1 2 3~~4 5 6~~Resultant Matrix:~~14 19 24~~14 19 24 ~~  Mark/s obtained: 3 out of 10~~~~~~Your output:~~Enter  number of rows of matrix A : Enter  number of columns of matrix A : Enter  number of rows of matrix B : Enter  number of columns of matrix B : Enter Matrix A : ~~Enter Matrix B : ~~~~~~Matrix A 2 x 2: ~~2 3 ~~2 3 ~~~~Matrix B 2 x 2: ~~1 2 ~~4 5 ~~Matrix C 2 x 2: ~~14 19 ~~14 19 ~~~~~~FAILED: Test Case 2: ~~INPUT:2 3 2 3~~~~1 2 3~~1 1 1~~~~2 3 3~~1 1 1~~Desired Output:~~~~Matrices before multiplication:~~Matrix A:~~1 2 3~~1 1 1~~Matrix B:~~2 3 3~~1 1 1~~Error: Invalid matrix sizes for multiplication! ~~  Mark/s obtained: 3 out of 10~~~~~~Your output:~~Enter  number of rows of matrix A : Enter  number of columns of matrix A : Enter  number of rows of matrix B : Enter  number of columns of matrix B : Enter Matrix A : ~~Enter Matrix B : ~~~~~~Matrix A 2 x 2: ~~1 2 ~~1 1 ~~~~Matrix B 2 x 2: ~~2 3 ~~1 1 ~~Matrix C 2 x 2: ~~4 5 ~~3 4 ~~~~~~========= CODE CASES =========~~~~~~FAILED: Code Case 1:~~Correct structure definition to store 2D matrix~~  Mark/s obtained: 3 out of 10~~~~~~FAILED: Code Case 2:~~Creation of matrix~~  Mark/s obtained: 3 out of 10~~~~~~FAILED: Code Case 3:~~Read and print of matrix~~  Mark/s obtained: 4 out of 10~~~~~~FAILED: Code Case 4:~~Matrix multiplication logic~~  Mark/s obtained: 15 out of 20~~~~~~FAILED: Code Case 5:~~Correct Resultant matrix~~  Mark/s obtained: 0 out of 10~~~~~~==============================~~~~########## TOTAL MARKS OBTAINED = 31/80 ##########
22EX10002;3;10;0;3;10;15;0;41;========= TEST CASES =========~~~~~~FAILED: Test Case 1: ~~INPUT:2 2 2 3~~~~2 3~~2 3~~~~1 2 3~~4 5 6~~Desired Output:~~~~Matrices before multiplication:~~Matrix A:~~2 3~~2 3~~Matrix B:~~1 2 3~~4 5 6~~Matrices after multiplication:~~Matrix A:~~2 3~~2 3~~Matrix B:~~1 2 3~~4 5 6~~Resultant Matrix:~~14 19 24~~14 19 24 ~~  Mark/s obtained: 3 out of 10~~~~~~Your output:~~[ERROR: SEGMENTATION_FAULT or RUNTIMEOUT.~~It may be due one of the following:~~+ Waits for more user input than expected/defined in the question or~~+ Code throws a math exception during runtime or~~+ Runs into an infinite loop or~~or something else completely, we will never know...~~]~~~~========= CODE CASES =========~~~~~~FAILED: Code Case 1:~~Correct structure definition to store 2D matrix~~  Mark/s obtained: 0 out of 10~~~~~~FAILED: Code Case 2:~~Creation of matrix~~  Mark/s obtained: 3 out of 10~~~~~~PASSED: Code Case 3:~~Read and print of matrix~~  Mark/s obtained: 10 out of 10~~~~~~FAILED: Code Case 4:~~Matrix multiplication logic~~  Mark/s obtained: 15 out of 20~~~~~~FAILED: Code Case 5:~~Correct Resultant matrix~~  Mark/s obtained: 0 out of 10~~~~~~==============================~~~~########## TOTAL MARKS OBTAINED = 41/80 ##########
22EX10022;0;0;0;0;0;0;0;0;========= TEST CASES =========~~~~~~FAILED: Code didn't compile successfully~~  Mark/s obtained: 0 out of 20~~~~~~========= CODE CASES =========~~~~~~FAILED: Code Case 1:~~Correct structure definition to store 2D matrix~~  Mark/s obtained: 0 out of 10~~~~~~FAILED: Code Case 2:~~Creation of matrix~~  Mark/s obtained: 0 out of 10~~~~~~FAILED: Code Case 3:~~Read and print of matrix~~  Mark/s obtained: 0 out of 10~~~~~~FAILED: Code Case 4:~~Matrix multiplication logic~~  Mark/s obtained: 0 out of 20~~~~~~FAILED: Code Case 5:~~Correct Resultant matrix~~  Mark/s obtained: 0 out of 10~~~~~~==============================~~~~########## TOTAL MARKS OBTAINED = 0/80 ###########
22EX10042;4;10;10;10;10;20;0;64;========= TEST CASES =========~~~~~~FAILED: Test Case 1: ~~INPUT:2 2 2 3~~~~2 3~~2 3~~~~1 2 3~~4 5 6~~Desired Output:~~~~Matrices before multiplication:~~Matrix A:~~2 3~~2 3~~Matrix B:~~1 2 3~~4 5 6~~Matrices after multiplication:~~Matrix A:~~2 3~~2 3~~Matrix B:~~1 2 3~~4 5 6~~Resultant Matrix:~~14 19 24~~14 19 24 ~~  Mark/s obtained: 4 out of 10~~~~~~Your output:~~enter the no of rows of a~~ enter the no of cols of a~~ enter the no of rows of b~~ enter the no of cols of b~~ enter the values of a~~~~enter the values of b~~~~matrix a is~~2 3 ~~2 3 ~~matrix b is~~1 2 3 ~~4 5 6 ~~matrix a after multiplication is~~2 3 ~~2 3 ~~matrix b after multiplication is~~1 2 3 ~~4 5 6 ~~resultant matrix is ~~14 14 14 ~~19 19 19 ~~~~~~========= CODE CASES =========~~~~~~PASSED: Code Case 1:~~Correct structure definition to store 2D matrix~~  Mark/s obtained: 10 out of 10~~~~~~PASSED: Code Case 2:~~Creation of matrix~~  Mark/s obtained: 10 out of 10~~~~~~PASSED: Code Case 3:~~Read and print of matrix~~  Mark/s obtained: 10 out of 10~~~~~~PASSED: Code Case 4:~~Matrix multiplication logic~~  Mark/s obtained: 20 out of 20~~~~~~FAILED: Code Case 5:~~Correct Resultant matrix~~  Mark/s obtained: 0 out of 10~~~~~~==============================~~~~########## TOTAL MARKS OBTAINED = 64/80 ##########
22GG10032;0;0;10;0;0;0;0;10;========= TEST CASES =========~~~~~~FAILED: Code didn't compile successfully~~  Mark/s obtained: 0 out of 20~~~~~~========= CODE CASES =========~~~~~~PASSED: Code Case 1:~~Correct structure definition to store 2D matrix~~  Mark/s obtained: 10 out of 10~~~~~~FAILED: Code Case 2:~~Creation of matrix~~  Mark/s obtained: 0 out of 10~~~~~~FAILED: Code Case 3:~~Read and print of matrix~~  Mark/s obtained: 0 out of 10~~~~~~FAILED: Code Case 4:~~Matrix multiplication logic~~  Mark/s obtained: 0 out of 20~~~~~~FAILED: Code Case 5:~~Correct Resultant matrix~~  Mark/s obtained: 0 out of 10~~~~~~==============================~~~~########## TOTAL MARKS OBTAINED = 10/80 ##########
# 22GG10052;0;0;0;0;0;0;0;0;========= TEST CASES =========~~~~~~FAILED: Test Case 1: ~~INPUT:2 2 2 3~~~~2 3~~2 3~~~~1 2 3~~4 5 6~~Desired Output:~~~~Matrices before multiplication:~~Matrix A:~~2 3~~2 3~~Matrix B:~~1 2 3~~4 5 6~~Matrices after multiplication:~~Matrix A:~~2 3~~2 3~~Matrix B:~~1 2 3~~4 5 6~~Resultant Matrix:~~14 19 24~~14 19 24 ~~  Mark/s obtained: 0 out of 10~~~~~~Your output:~~Enter the number of students~~Enter the roll no for student 1~~Enter the marks for 3 subjects~~Enter the roll no for student 2~~Enter the marks for 3 subjects~~Student records :~~Roll No : 2~~Marks : 2.00 3.00 2.00~~Total : 7.00~~Roll No : 3~~Marks : 2.00 3.00 1.00~~Total : 6.00~~Student records :~~Roll No : 2~~Marks : 2.00 3.00 2.00~~Total : 7.00~~Roll No : 3~~Marks : 2.00 3.00 1.00~~Total : 6.00~~~~~~FAILED: Test Case 2: ~~INPUT:2 3 2 3~~~~1 2 3~~1 1 1~~~~2 3 3~~1 1 1~~Desired Output:~~~~Matrices before multiplication:~~Matrix A:~~1 2 3~~1 1 1~~Matrix B:~~2 3 3~~1 1 1~~Error: Invalid matrix sizes for multiplication! ~~  Mark/s obtained: 0 out of 10~~~~~~Your output:~~Enter the number of students~~Enter the roll no for student 1~~Enter the marks for 3 subjects~~Enter the roll no for student 2~~Enter the marks for 3 subjects~~Student records :~~Roll No : 3~~Marks : 2.00 3.00 1.00~~Total : 6.00~~Roll No : 2~~Marks : 3.00 1.00 1.00~~Total : 5.00~~Student records :~~Roll No : 3~~Marks : 2.00 3.00 1.00~~Total : 6.00~~Roll No : 2~~Marks : 3.00 1.00 1.00~~Total : 5.00~~~~~~========= CODE CASES =========~~~~~~FAILED: Code Case 1:~~Correct structure definition to store 2D matrix~~  Mark/s obtained: 0 out of 10~~~~~~FAILED: Code Case 2:~~Creation of matrix~~  Mark/s obtained: 0 out of 10~~~~~~FAILED: Code Case 3:~~Read and print of matrix~~  Mark/s obtained: 0 out of 10~~~~~~FAILED: Code Case 4:~~Matrix multiplication logic~~  Mark/s obtained: 0 out of 20~~~~~~FAILED: Code Case 5:~~Correct Resultant matrix~~  Mark/s obtained: 0 out of 10~~~~~~==============================~~~~########## TOTAL MARKS OBTAINED = 0/80 ###########
22HS10018;3;3;4;3;6;0;0;19;========= TEST CASES =========~~~~~~FAILED: Test Case 1: ~~INPUT:2 2 2 3~~~~2 3~~2 3~~~~1 2 3~~4 5 6~~Desired Output:~~~~Matrices before multiplication:~~Matrix A:~~2 3~~2 3~~Matrix B:~~1 2 3~~4 5 6~~Matrices after multiplication:~~Matrix A:~~2 3~~2 3~~Matrix B:~~1 2 3~~4 5 6~~Resultant Matrix:~~14 19 24~~14 19 24 ~~  Mark/s obtained: 3 out of 10~~~~~~Your output:~~Enter rows of matrix A: Enter columns of matrix A: Enter rows of matrix B: Enter columns of matrix B: Enter Elements of matrix A: ~~Enter Elements of matrix B: ~~Matrix A before multiplication is: ~~ 2 3~~ 2 3~~Matrix B before multiplication is: ~~ 1 2 3~~ 4 5 6~~~~~~FAILED: Test Case 2: ~~INPUT:2 3 2 3~~~~1 2 3~~1 1 1~~~~2 3 3~~1 1 1~~Desired Output:~~~~Matrices before multiplication:~~Matrix A:~~1 2 3~~1 1 1~~Matrix B:~~2 3 3~~1 1 1~~Error: Invalid matrix sizes for multiplication! ~~  Mark/s obtained: 3 out of 10~~~~~~Your output:~~Enter rows of matrix A: Enter columns of matrix A: Enter rows of matrix B: Enter columns of matrix B: Enter Elements of matrix A: ~~Enter Elements of matrix B: ~~Matrix A before multiplication is: ~~ 1 2 3~~ 1 1 1~~Matrix B before multiplication is: ~~ 2 3 3~~ 1 1 1~~~~~~========= CODE CASES =========~~~~~~FAILED: Code Case 1:~~Correct structure definition to store 2D matrix~~  Mark/s obtained: 4 out of 10~~~~~~FAILED: Code Case 2:~~Creation of matrix~~  Mark/s obtained: 3 out of 10~~~~~~FAILED: Code Case 3:~~Read and print of matrix~~  Mark/s obtained: 6 out of 10~~~~~~FAILED: Code Case 4:~~Matrix multiplication logic~~  Mark/s obtained: 0 out of 20~~~~~~FAILED: Code Case 5:~~Correct Resultant matrix~~  Mark/s obtained: 0 out of 10~~~~~~==============================~~~~########## TOTAL MARKS OBTAINED = 19/80 ##########
22HS10038;4;10;10;10;10;9;0;53;========= TEST CASES =========~~~~~~FAILED: Test Case 1: ~~INPUT:2 2 2 3~~~~2 3~~2 3~~~~1 2 3~~4 5 6~~Desired Output:~~~~Matrices before multiplication:~~Matrix A:~~2 3~~2 3~~Matrix B:~~1 2 3~~4 5 6~~Matrices after multiplication:~~Matrix A:~~2 3~~2 3~~Matrix B:~~1 2 3~~4 5 6~~Resultant Matrix:~~14 19 24~~14 19 24 ~~  Mark/s obtained: 4 out of 10~~~~~~Your output:~~Enter the number of rows for Matix A: ~~Enter the number of columns for Matix A: ~~Enter the number of rows for Matix B: ~~Enter the number of columns for Matix B: Enter the values for Matrix A ~~Enter the values for Matrix B~~Matrix A:-~~2 3 ~~2 3 ~~Matrix B:-~~1 2 3 ~~4 5 6 ~~Matrices after Multiplication~~Resultant Matrix:- ~~1900894 19 1900904 ~~1900894 19 1900904 ~~Matrix A:-~~2 3 ~~2 3 ~~Matrix B:-~~1 2 3 ~~4 5 6 ~~~~~~========= CODE CASES =========~~~~~~PASSED: Code Case 1:~~Correct structure definition to store 2D matrix~~  Mark/s obtained: 10 out of 10~~~~~~PASSED: Code Case 2:~~Creation of matrix~~  Mark/s obtained: 10 out of 10~~~~~~PASSED: Code Case 3:~~Read and print of matrix~~  Mark/s obtained: 10 out of 10~~~~~~FAILED: Code Case 4:~~Matrix multiplication logic~~  Mark/s obtained: 9 out of 20~~~~~~FAILED: Code Case 5:~~Correct Resultant matrix~~  Mark/s obtained: 0 out of 10~~~~~~==============================~~~~########## TOTAL MARKS OBTAINED = 53/80 ##########
22HS10058;4;10;10;10;10;9;0;53;========= TEST CASES =========~~~~~~FAILED: Test Case 1: ~~INPUT:2 2 2 3~~~~2 3~~2 3~~~~1 2 3~~4 5 6~~Desired Output:~~~~Matrices before multiplication:~~Matrix A:~~2 3~~2 3~~Matrix B:~~1 2 3~~4 5 6~~Matrices after multiplication:~~Matrix A:~~2 3~~2 3~~Matrix B:~~1 2 3~~4 5 6~~Resultant Matrix:~~14 19 24~~14 19 24 ~~  Mark/s obtained: 4 out of 10~~~~~~Your output:~~Enter the number of rows for matrix A: Enter the number of columns for matrix A: Enter the number of rows for matrix A: Enter the number of columns for matrix A: Enter the values for matrix A :~~Matrix A:~~2 3 ~~2 3 ~~Matrix B:~~1 2 3 ~~4 5 6 ~~Matrix before Multiplication :~~Matrix A:~~2 3 ~~2 3 ~~Matrix B:~~1 2 3 ~~4 5 6 ~~Matrix after Multiplication :~~Matrix A:~~2 3 ~~2 3 ~~Matrix B:~~1 2 3 ~~4 5 6 ~~Resultant Matrix :~~11272542 19 11272552 ~~11272542 19 11272552 ~~~~~~========= CODE CASES =========~~~~~~PASSED: Code Case 1:~~Correct structure definition to store 2D matrix~~  Mark/s obtained: 10 out of 10~~~~~~PASSED: Code Case 2:~~Creation of matrix~~  Mark/s obtained: 10 out of 10~~~~~~PASSED: Code Case 3:~~Read and print of matrix~~  Mark/s obtained: 10 out of 10~~~~~~FAILED: Code Case 4:~~Matrix multiplication logic~~  Mark/s obtained: 9 out of 20~~~~~~FAILED: Code Case 5:~~Correct Resultant matrix~~  Mark/s obtained: 0 out of 10~~~~~~==============================~~~~########## TOTAL MARKS OBTAINED = 53/80 ##########
22IE10015;4;10;10;10;10;9;0;53;========= TEST CASES =========~~~~~~FAILED: Test Case 1: ~~INPUT:2 2 2 3~~~~2 3~~2 3~~~~1 2 3~~4 5 6~~Desired Output:~~~~Matrices before multiplication:~~Matrix A:~~2 3~~2 3~~Matrix B:~~1 2 3~~4 5 6~~Matrices after multiplication:~~Matrix A:~~2 3~~2 3~~Matrix B:~~1 2 3~~4 5 6~~Resultant Matrix:~~14 19 24~~14 19 24 ~~  Mark/s obtained: 4 out of 10~~~~~~Your output:~~Enter the no. of rows for matrix A:~~Enter the no. of coloumns for matrix A:~~Enter the no. of rows for matrix B:~~Enter the no. of coloumns for matrix B:~~~~Enter the values for matrix A~~~~~~Enter the values for matrix B~~~~Matrix before multiplication~~:~~Matrix A:~~2 3 ~~2 3 ~~~~Matrix B:~~1 2 3 ~~4 5 6 ~~~~ Matrices after multiplication:~~~~Matrix A:~~2 3 ~~2 3 ~~~~Matrix B:~~1 2 3 ~~4 5 6 ~~~~Matrix C:~~8454494 19 8454504 ~~1230983773 1414415703 1162430049 ~~~~~~========= CODE CASES =========~~~~~~PASSED: Code Case 1:~~Correct structure definition to store 2D matrix~~  Mark/s obtained: 10 out of 10~~~~~~PASSED: Code Case 2:~~Creation of matrix~~  Mark/s obtained: 10 out of 10~~~~~~PASSED: Code Case 3:~~Read and print of matrix~~  Mark/s obtained: 10 out of 10~~~~~~FAILED: Code Case 4:~~Matrix multiplication logic~~  Mark/s obtained: 9 out of 20~~~~~~FAILED: Code Case 5:~~Correct Resultant matrix~~  Mark/s obtained: 0 out of 10~~~~~~==============================~~~~########## TOTAL MARKS OBTAINED = 53/80 ##########
22IE10035;0;0;0;0;0;0;0;0;A file was not submitted properly ~~Mark/s lost: 80 out of 80~~~~~~==============================~~~~########## TOTAL MARKS OBTAINED = 0/80 ###########
22IM10009;2;2;3;0;0;0;0;7;========= TEST CASES =========~~~~~~FAILED: Test Case 1: ~~INPUT:2 2 2 3~~~~2 3~~2 3~~~~1 2 3~~4 5 6~~Desired Output:~~~~Matrices before multiplication:~~Matrix A:~~2 3~~2 3~~Matrix B:~~1 2 3~~4 5 6~~Matrices after multiplication:~~Matrix A:~~2 3~~2 3~~Matrix B:~~1 2 3~~4 5 6~~Resultant Matrix:~~14 19 24~~14 19 24 ~~  Mark/s obtained: 2 out of 10~~~~~~Your output:~~enter the no. of rows for matrix A~~enter the no. of columns for matrix A~~enter the no. of rows for matrix B~~enter the no. of columns for matrix B~~~~~~FAILED: Test Case 2: ~~INPUT:2 3 2 3~~~~1 2 3~~1 1 1~~~~2 3 3~~1 1 1~~Desired Output:~~~~Matrices before multiplication:~~Matrix A:~~1 2 3~~1 1 1~~Matrix B:~~2 3 3~~1 1 1~~Error: Invalid matrix sizes for multiplication! ~~  Mark/s obtained: 2 out of 10~~~~~~Your output:~~enter the no. of rows for matrix A~~enter the no. of columns for matrix A~~enter the no. of rows for matrix B~~enter the no. of columns for matrix B~~~~~~========= CODE CASES =========~~~~~~FAILED: Code Case 1:~~Correct structure definition to store 2D matrix~~  Mark/s obtained: 3 out of 10~~~~~~FAILED: Code Case 2:~~Creation of matrix~~  Mark/s obtained: 0 out of 10~~~~~~FAILED: Code Case 3:~~Read and print of matrix~~  Mark/s obtained: 0 out of 10~~~~~~FAILED: Code Case 4:~~Matrix multiplication logic~~  Mark/s obtained: 0 out of 20~~~~~~FAILED: Code Case 5:~~Correct Resultant matrix~~  Mark/s obtained: 0 out of 10~~~~~~==============================~~~~########## TOTAL MARKS OBTAINED = 7/80 ###########
22IM10028;4;0;10;10;10;0;0;34;========= TEST CASES =========~~~~~~FAILED: Test Case 1: ~~INPUT:2 2 2 3~~~~2 3~~2 3~~~~1 2 3~~4 5 6~~Desired Output:~~~~Matrices before multiplication:~~Matrix A:~~2 3~~2 3~~Matrix B:~~1 2 3~~4 5 6~~Matrices after multiplication:~~Matrix A:~~2 3~~2 3~~Matrix B:~~1 2 3~~4 5 6~~Resultant Matrix:~~14 19 24~~14 19 24 ~~  Mark/s obtained: 4 out of 10~~~~~~Your output:~~Enter the number of rows for matrix A:Enter the number of columns for matrix AEnter the number of rows for matrix B:Enter the number of columns for matrix BEnter the values for matrix A:Matrices before~~Matrix A~~2060096206010020601282060132Matrix B~~206019220601962060200203769620377002037704~~~~FAILED: Test Case 2: ~~INPUT:2 3 2 3~~~~1 2 3~~1 1 1~~~~2 3 3~~1 1 1~~Desired Output:~~~~Matrices before multiplication:~~Matrix A:~~1 2 3~~1 1 1~~Matrix B:~~2 3 3~~1 1 1~~Error: Invalid matrix sizes for multiplication! ~~  Mark/s obtained: 0 out of 10~~~~~~Your output:~~Enter the number of rows for matrix A:Enter the number of columns for matrix AEnter the number of rows for matrix B:Enter the number of columns for matrix BEnter the values for matrix A:Matrices before~~Matrix A~~854816085481648548168854819285481968548200Matrix B~~854825685482608548264852576085257648525768~~~~========= CODE CASES =========~~~~~~PASSED: Code Case 1:~~Correct structure definition to store 2D matrix~~  Mark/s obtained: 10 out of 10~~~~~~PASSED: Code Case 2:~~Creation of matrix~~  Mark/s obtained: 10 out of 10~~~~~~PASSED: Code Case 3:~~Read and print of matrix~~  Mark/s obtained: 10 out of 10~~~~~~FAILED: Code Case 4:~~Matrix multiplication logic~~  Mark/s obtained: 0 out of 20~~~~~~FAILED: Code Case 5:~~Correct Resultant matrix~~  Mark/s obtained: 0 out of 10~~~~~~==============================~~~~########## TOTAL MARKS OBTAINED = 34/80 ##########
22IM30022;0;0;0;0;0;0;0;0;A file was not submitted properly ~~Mark/s lost: 80 out of 80~~~~~~==============================~~~~########## TOTAL MARKS OBTAINED = 0/80 ###########
22MA10010;0;0;0;0;0;0;0;0;A file was not submitted properly ~~Mark/s lost: 80 out of 80~~~~~~==============================~~~~########## TOTAL MARKS OBTAINED = 0/80 ###########
22MA10029;4;10;10;10;10;9;0;53;========= TEST CASES =========~~~~~~FAILED: Test Case 1: ~~INPUT:2 2 2 3~~~~2 3~~2 3~~~~1 2 3~~4 5 6~~Desired Output:~~~~Matrices before multiplication:~~Matrix A:~~2 3~~2 3~~Matrix B:~~1 2 3~~4 5 6~~Matrices after multiplication:~~Matrix A:~~2 3~~2 3~~Matrix B:~~1 2 3~~4 5 6~~Resultant Matrix:~~14 19 24~~14 19 24 ~~  Mark/s obtained: 4 out of 10~~~~~~Your output:~~Enter the number of rows for matrix A: Enter the number of columns for matrix A: Enter the number of rows for matrix B: Enter the number of columns for matrix B: ~~Enter the values for matrix A:~~~~Enter the values for matrix B:~~~~~~~~Matrices before multiplication :~~Matrix A:~~    2    3~~    2    3~~~~Matrix B:~~    1    2    3~~    4    5    6~~~~~~~~Matrices after multiplication :~~Matrix A:~~    2    3~~    2    3~~~~Matrix B:~~    1    2    3~~    4    5    6~~~~Resultant matrix:~~190089...~~~~========= CODE CASES =========~~~~~~PASSED: Code Case 1:~~Correct structure definition to store 2D matrix~~  Mark/s obtained: 10 out of 10~~~~~~PASSED: Code Case 2:~~Creation of matrix~~  Mark/s obtained: 10 out of 10~~~~~~PASSED: Code Case 3:~~Read and print of matrix~~  Mark/s obtained: 10 out of 10~~~~~~FAILED: Code Case 4:~~Matrix multiplication logic~~  Mark/s obtained: 9 out of 20~~~~~~FAILED: Code Case 5:~~Correct Resultant matrix~~  Mark/s obtained: 0 out of 10~~~~~~==============================~~~~########## TOTAL MARKS OBTAINED = 53/80 ##########
22MA10048;10;10;10;10;10;20;10;80;Great Job~~~~========= TEST CASES =========~~~~PASSED: All test cases - Marks : 20 out of 20~~~~========= CODE CASES =========~~~~~~PASSED: Code Case 1:~~Correct structure definition to store 2D matrix~~  Mark/s obtained: 10 out of 10~~~~~~PASSED: Code Case 2:~~Creation of matrix~~  Mark/s obtained: 10 out of 10~~~~~~PASSED: Code Case 3:~~Read and print of matrix~~  Mark/s obtained: 10 out of 10~~~~~~PASSED: Code Case 4:~~Matrix multiplication logic~~  Mark/s obtained: 20 out of 20~~~~~~PASSED: Code Case 5:~~Correct Resultant matrix~~  Mark/s obtained: 10 out of 10~~~~PASSED: All code cases - Marks : 60 out of 60~~~~==============================~~~~########## TOTAL MARKS OBTAINED = 80/80 ##########
22MA10067;4;10;7;10;7;0;0;38;========= TEST CASES =========~~~~~~FAILED: Test Case 1: ~~INPUT:2 2 2 3~~~~2 3~~2 3~~~~1 2 3~~4 5 6~~Desired Output:~~~~Matrices before multiplication:~~Matrix A:~~2 3~~2 3~~Matrix B:~~1 2 3~~4 5 6~~Matrices after multiplication:~~Matrix A:~~2 3~~2 3~~Matrix B:~~1 2 3~~4 5 6~~Resultant Matrix:~~14 19 24~~14 19 24 ~~  Mark/s obtained: 4 out of 10~~~~~~Your output:~~Enter the number of rows for matrix A: Enter the number of columns for matrix A: Enter the number of rows for matrix B: Enter the number of columns for matrix B: Enter the value for matrix A (2*2):Row 1: Row 2: Enter the value for matrix A (2*3):Row 1: Row 2: Matrix before multiplication:~~Matrix A:~~2 3 ~~2 3 ~~Matrix before multiplication:~~Matrix B:~~2 3 9044304 ~~2 3 9044304 ~~~~Matrix after multiplication:~~Matrix A:~~2 3 ~~2 3 ~~Matrix before multiplication:~~Matrix B:~~1 2 3 ~~4 5 6 ~~~~~~========= CODE CASES =========~~~~~~FAILED: Code Case 1:~~Correct structure definition to store 2D matrix~~  Mark/s obtained: 7 out of 10~~~~~~PASSED: Code Case 2:~~Creation of matrix~~  Mark/s obtained: 10 out of 10~~~~~~FAILED: Code Case 3:~~Read and print of matrix~~  Mark/s obtained: 7 out of 10~~~~~~FAILED: Code Case 4:~~Matrix multiplication logic~~  Mark/s obtained: 0 out of 20~~~~~~FAILED: Code Case 5:~~Correct Resultant matrix~~  Mark/s obtained: 0 out of 10~~~~~~==============================~~~~########## TOTAL MARKS OBTAINED = 38/80 ##########
22ME10015;0;0;0;0;0;0;0;0;A file was not submitted properly ~~Mark/s lost: 80 out of 80~~~~~~==============================~~~~########## TOTAL MARKS OBTAINED = 0/80 ###########
22ME10034;0;0;0;0;0;0;0;0;========= TEST CASES =========~~~~~~FAILED: Code didn't compile successfully~~  Mark/s obtained: 0 out of 20~~~~~~========= CODE CASES =========~~~~~~FAILED: Code Case 1:~~Correct structure definition to store 2D matrix~~  Mark/s obtained: 0 out of 10~~~~~~FAILED: Code Case 2:~~Creation of matrix~~  Mark/s obtained: 0 out of 10~~~~~~FAILED: Code Case 3:~~Read and print of matrix~~  Mark/s obtained: 0 out of 10~~~~~~FAILED: Code Case 4:~~Matrix multiplication logic~~  Mark/s obtained: 0 out of 20~~~~~~FAILED: Code Case 5:~~Correct Resultant matrix~~  Mark/s obtained: 0 out of 10~~~~~~==============================~~~~########## TOTAL MARKS OBTAINED = 0/80 ###########
22ME10053;4;10;10;10;10;4;0;48;========= TEST CASES =========~~~~~~FAILED: Test Case 1: ~~INPUT:2 2 2 3~~~~2 3~~2 3~~~~1 2 3~~4 5 6~~Desired Output:~~~~Matrices before multiplication:~~Matrix A:~~2 3~~2 3~~Matrix B:~~1 2 3~~4 5 6~~Matrices after multiplication:~~Matrix A:~~2 3~~2 3~~Matrix B:~~1 2 3~~4 5 6~~Resultant Matrix:~~14 19 24~~14 19 24 ~~  Mark/s obtained: 4 out of 10~~~~~~Your output:~~Enter the number of rows for matrix A : ~~Enter the number of columns for matrix A :~~ Enter the number of rows for matrix B : ~~Enter the number of columns for matrix B :~~ Enter the values of matrix A : ~~Enter the values of matrix B :~~Matrices before multiplication :~~Matrix A :~~2 3 ~~2 3 ~~Matrix B :~~1 2 3 ~~4 5 6 ~~Resultant matrix : ~~1900894 19 1900904 ~~1900894 19 1900904 ~~~~~~========= CODE CASES =========~~~~~~PASSED: Code Case 1:~~Correct structure definition to store 2D matrix~~  Mark/s obtained: 10 out of 10~~~~~~PASSED: Code Case 2:~~Creation of matrix~~  Mark/s obtained: 10 out of 10~~~~~~PASSED: Code Case 3:~~Read and print of matrix~~  Mark/s obtained: 10 out of 10~~~~~~FAILED: Code Case 4:~~Matrix multiplication logic~~  Mark/s obtained: 4 out of 20~~~~~~FAILED: Code Case 5:~~Correct Resultant matrix~~  Mark/s obtained: 0 out of 10~~~~~~==============================~~~~########## TOTAL MARKS OBTAINED = 48/80 ##########
22ME10072;0;0;0;4;4;8;0;16;========= TEST CASES =========~~~~~~FAILED: Code didn't compile successfully~~  Mark/s obtained: 0 out of 20~~~~~~========= CODE CASES =========~~~~~~FAILED: Code Case 1:~~Correct structure definition to store 2D matrix~~  Mark/s obtained: 0 out of 10~~~~~~FAILED: Code Case 2:~~Creation of matrix~~  Mark/s obtained: 4 out of 10~~~~~~FAILED: Code Case 3:~~Read and print of matrix~~  Mark/s obtained: 4 out of 10~~~~~~FAILED: Code Case 4:~~Matrix multiplication logic~~  Mark/s obtained: 8 out of 20~~~~~~FAILED: Code Case 5:~~Correct Resultant matrix~~  Mark/s obtained: 0 out of 10~~~~~~==============================~~~~########## TOTAL MARKS OBTAINED = 16/80 ##########
22ME10091;10;10;10;10;10;20;10;80;Keep up the good work~~~~========= TEST CASES =========~~~~PASSED: All test cases - Marks : 20 out of 20~~~~========= CODE CASES =========~~~~~~PASSED: Code Case 1:~~Correct structure definition to store 2D matrix~~  Mark/s obtained: 10 out of 10~~~~~~PASSED: Code Case 2:~~Creation of matrix~~  Mark/s obtained: 10 out of 10~~~~~~PASSED: Code Case 3:~~Read and print of matrix~~  Mark/s obtained: 10 out of 10~~~~~~PASSED: Code Case 4:~~Matrix multiplication logic~~  Mark/s obtained: 20 out of 20~~~~~~PASSED: Code Case 5:~~Correct Resultant matrix~~  Mark/s obtained: 10 out of 10~~~~PASSED: All code cases - Marks : 60 out of 60~~~~==============================~~~~########## TOTAL MARKS OBTAINED = 80/80 ##########
22ME30012;10;10;10;10;10;20;10;80;Nice work~~~~========= TEST CASES =========~~~~PASSED: All test cases - Marks : 20 out of 20~~~~========= CODE CASES =========~~~~~~PASSED: Code Case 1:~~Correct structure definition to store 2D matrix~~  Mark/s obtained: 10 out of 10~~~~~~PASSED: Code Case 2:~~Creation of matrix~~  Mark/s obtained: 10 out of 10~~~~~~PASSED: Code Case 3:~~Read and print of matrix~~  Mark/s obtained: 10 out of 10~~~~~~PASSED: Code Case 4:~~Matrix multiplication logic~~  Mark/s obtained: 20 out of 20~~~~~~PASSED: Code Case 5:~~Correct Resultant matrix~~  Mark/s obtained: 10 out of 10~~~~PASSED: All code cases - Marks : 60 out of 60~~~~==============================~~~~########## TOTAL MARKS OBTAINED = 80/80 ##########
22ME30031;0;0;10;0;0;0;0;10;========= TEST CASES =========~~~~~~FAILED: Code didn't compile successfully~~  Mark/s obtained: 0 out of 20~~~~~~========= CODE CASES =========~~~~~~PASSED: Code Case 1:~~Correct structure definition to store 2D matrix~~  Mark/s obtained: 10 out of 10~~~~~~FAILED: Code Case 2:~~Creation of matrix~~  Mark/s obtained: 0 out of 10~~~~~~FAILED: Code Case 3:~~Read and print of matrix~~  Mark/s obtained: 0 out of 10~~~~~~FAILED: Code Case 4:~~Matrix multiplication logic~~  Mark/s obtained: 0 out of 20~~~~~~FAILED: Code Case 5:~~Correct Resultant matrix~~  Mark/s obtained: 0 out of 10~~~~~~==============================~~~~########## TOTAL MARKS OBTAINED = 10/80 ##########
22ME30050;10;10;10;10;10;20;10;80;Perfect~~~~========= TEST CASES =========~~~~PASSED: All test cases - Marks : 20 out of 20~~~~========= CODE CASES =========~~~~~~PASSED: Code Case 1:~~Correct structure definition to store 2D matrix~~  Mark/s obtained: 10 out of 10~~~~~~PASSED: Code Case 2:~~Creation of matrix~~  Mark/s obtained: 10 out of 10~~~~~~PASSED: Code Case 3:~~Read and print of matrix~~  Mark/s obtained: 10 out of 10~~~~~~PASSED: Code Case 4:~~Matrix multiplication logic~~  Mark/s obtained: 20 out of 20~~~~~~PASSED: Code Case 5:~~Correct Resultant matrix~~  Mark/s obtained: 10 out of 10~~~~PASSED: All code cases - Marks : 60 out of 60~~~~==============================~~~~########## TOTAL MARKS OBTAINED = 80/80 ##########
22MF10015;0;0;0;0;0;0;0;0;A file was not submitted properly ~~Mark/s lost: 80 out of 80~~~~~~==============================~~~~########## TOTAL MARKS OBTAINED = 0/80 ###########
22MF10034;0;0;10;2;0;0;0;12;========= TEST CASES =========~~~~~~FAILED: Code didn't compile successfully~~  Mark/s obtained: 0 out of 20~~~~~~========= CODE CASES =========~~~~~~PASSED: Code Case 1:~~Correct structure definition to store 2D matrix~~  Mark/s obtained: 10 out of 10~~~~~~FAILED: Code Case 2:~~Creation of matrix~~  Mark/s obtained: 2 out of 10~~~~~~FAILED: Code Case 3:~~Read and print of matrix~~  Mark/s obtained: 0 out of 10~~~~~~FAILED: Code Case 4:~~Matrix multiplication logic~~  Mark/s obtained: 0 out of 20~~~~~~FAILED: Code Case 5:~~Correct Resultant matrix~~  Mark/s obtained: 0 out of 10~~~~~~==============================~~~~########## TOTAL MARKS OBTAINED = 12/80 ##########
22MF3IM06;0;0;0;0;0;0;0;0;A file was not submitted properly ~~Mark/s lost: 80 out of 80~~~~~~==============================~~~~########## TOTAL MARKS OBTAINED = 0/80 ###########
22MI10002;10;0;10;10;10;20;10;70;========= TEST CASES =========~~~~~~FAILED: Test Case 2: ~~INPUT:2 3 2 3~~~~1 2 3~~1 1 1~~~~2 3 3~~1 1 1~~Desired Output:~~~~Matrices before multiplication:~~Matrix A:~~1 2 3~~1 1 1~~Matrix B:~~2 3 3~~1 1 1~~Error: Invalid matrix sizes for multiplication! ~~  Mark/s obtained: 0 out of 10~~~~~~Your output:~~[ERROR: SEGMENTATION_FAULT or RUNTIMEOUT.~~It may be due one of the following:~~+ Waits for more user input than expected/defined in the question or~~+ Code throws a math exception during runtime or~~+ Runs into an infinite loop or~~or something else completely, we will never know...~~]~~~~========= CODE CASES =========~~~~~~PASSED: Code Case 1:~~Correct structure definition to store 2D matrix~~  Mark/s obtained: 10 out of 10~~~~~~PASSED: Code Case 2:~~Creation of matrix~~  Mark/s obtained: 10 out of 10~~~~~~PASSED: Code Case 3:~~Read and print of matrix~~  Mark/s obtained: 10 out of 10~~~~~~PASSED: Code Case 4:~~Matrix multiplication logic~~  Mark/s obtained: 20 out of 20~~~~~~PASSED: Code Case 5:~~Correct Resultant matrix~~  Mark/s obtained: 10 out of 10~~~~PASSED: All code cases - Marks : 60 out of 60~~~~==============================~~~~########## TOTAL MARKS OBTAINED = 70/80 ##########
22MI10040;10;10;10;10;10;20;10;80;Keep it up~~~~========= TEST CASES =========~~~~PASSED: All test cases - Marks : 20 out of 20~~~~========= CODE CASES =========~~~~~~PASSED: Code Case 1:~~Correct structure definition to store 2D matrix~~  Mark/s obtained: 10 out of 10~~~~~~PASSED: Code Case 2:~~Creation of matrix~~  Mark/s obtained: 10 out of 10~~~~~~PASSED: Code Case 3:~~Read and print of matrix~~  Mark/s obtained: 10 out of 10~~~~~~PASSED: Code Case 4:~~Matrix multiplication logic~~  Mark/s obtained: 20 out of 20~~~~~~PASSED: Code Case 5:~~Correct Resultant matrix~~  Mark/s obtained: 10 out of 10~~~~PASSED: All code cases - Marks : 60 out of 60~~~~==============================~~~~########## TOTAL MARKS OBTAINED = 80/80 ##########
22MI10059;0;0;0;0;0;0;0;0;========= TEST CASES =========~~~~~~FAILED: Test Case 1: ~~INPUT:2 2 2 3~~~~2 3~~2 3~~~~1 2 3~~4 5 6~~Desired Output:~~~~Matrices before multiplication:~~Matrix A:~~2 3~~2 3~~Matrix B:~~1 2 3~~4 5 6~~Matrices after multiplication:~~Matrix A:~~2 3~~2 3~~Matrix B:~~1 2 3~~4 5 6~~Resultant Matrix:~~14 19 24~~14 19 24 ~~  Mark/s obtained: 0 out of 10~~~~~~Your output:~~z1: 2.000000 + 2.000000i~~z2: 2.000000 + 3.000000i~~z1+z2: 4.000000 + 5.000000i~~z1-z2: 0.000000 + -1.000000i~~z1*z2: -2.000000 + 10.000000i~~z1/z2: 0.769231 + 0.153846i~~|z1|: 2.828427~~|z2|: 3.605551~~z: 3.853415 +-0.170732i~~|z|:3.857195~~~~FAILED: Test Case 2: ~~INPUT:2 3 2 3~~~~1 2 3~~1 1 1~~~~2 3 3~~1 1 1~~Desired Output:~~~~Matrices before multiplication:~~Matrix A:~~1 2 3~~1 1 1~~Matrix B:~~2 3 3~~1 1 1~~Error: Invalid matrix sizes for multiplication! ~~  Mark/s obtained: 0 out of 10~~~~~~Your output:~~z1: 2.000000 + 3.000000i~~z2: 2.000000 + 3.000000i~~z1+z2: 4.000000 + 6.000000i~~z1-z2: 0.000000 + 0.000000i~~z1*z2: -5.000000 + 12.000000i~~z1/z2: 1.000000 + 0.000000i~~|z1|: 3.605551~~|z2|: 3.605551~~z: 4.390000 +0.000000i~~|z|:4.390000~~~~========= CODE CASES =========~~~~~~FAILED: Code Case 1:~~Correct structure definition to store 2D matrix~~  Mark/s obtained: 0 out of 10~~~~~~FAILED: Code Case 2:~~Creation of matrix~~  Mark/s obtained: 0 out of 10~~~~~~FAILED: Code Case 3:~~Read and print of matrix~~  Mark/s obtained: 0 out of 10~~~~~~FAILED: Code Case 4:~~Matrix multiplication logic~~  Mark/s obtained: 0 out of 20~~~~~~FAILED: Code Case 5:~~Correct Resultant matrix~~  Mark/s obtained: 0 out of 10~~~~~~==============================~~~~########## TOTAL MARKS OBTAINED = 0/80 ###########
22MI31014;10;10;0;3;10;20;10;63;========= TEST CASES =========~~~~PASSED: All test cases - Marks : 20 out of 20~~~~========= CODE CASES =========~~~~~~FAILED: Code Case 1:~~Correct structure definition to store 2D matrix~~  Mark/s obtained: 0 out of 10~~~~~~FAILED: Code Case 2:~~Creation of matrix~~  Mark/s obtained: 3 out of 10~~~~~~PASSED: Code Case 3:~~Read and print of matrix~~  Mark/s obtained: 10 out of 10~~~~~~PASSED: Code Case 4:~~Matrix multiplication logic~~  Mark/s obtained: 20 out of 20~~~~~~PASSED: Code Case 5:~~Correct Resultant matrix~~  Mark/s obtained: 10 out of 10~~~~~~==============================~~~~########## TOTAL MARKS OBTAINED = 63/80 ##########
22MI33002;0;0;10;0;0;0;0;10;========= TEST CASES =========~~~~~~FAILED: Code didn't compile successfully~~  Mark/s obtained: 0 out of 20~~~~~~========= CODE CASES =========~~~~~~PASSED: Code Case 1:~~Correct structure definition to store 2D matrix~~  Mark/s obtained: 10 out of 10~~~~~~FAILED: Code Case 2:~~Creation of matrix~~  Mark/s obtained: 0 out of 10~~~~~~FAILED: Code Case 3:~~Read and print of matrix~~  Mark/s obtained: 0 out of 10~~~~~~FAILED: Code Case 4:~~Matrix multiplication logic~~  Mark/s obtained: 0 out of 20~~~~~~FAILED: Code Case 5:~~Correct Resultant matrix~~  Mark/s obtained: 0 out of 10~~~~~~==============================~~~~########## TOTAL MARKS OBTAINED = 10/80 ##########
22MI33021;0;0;0;0;0;0;0;0;========= TEST CASES =========~~~~~~FAILED: Test Case 1: ~~INPUT:2 2 2 3~~~~2 3~~2 3~~~~1 2 3~~4 5 6~~Desired Output:~~~~Matrices before multiplication:~~Matrix A:~~2 3~~2 3~~Matrix B:~~1 2 3~~4 5 6~~Matrices after multiplication:~~Matrix A:~~2 3~~2 3~~Matrix B:~~1 2 3~~4 5 6~~Resultant Matrix:~~14 19 24~~14 19 24 ~~  Mark/s obtained: 0 out of 10~~~~~~Your output:~~enter the rows of matrix a :enter the columns of matrix a :enter the rows of matrix b :enter the columns of matrix b~~~~FAILED: Test Case 2: ~~INPUT:2 3 2 3~~~~1 2 3~~1 1 1~~~~2 3 3~~1 1 1~~Desired Output:~~~~Matrices before multiplication:~~Matrix A:~~1 2 3~~1 1 1~~Matrix B:~~2 3 3~~1 1 1~~Error: Invalid matrix sizes for multiplication! ~~  Mark/s obtained: 0 out of 10~~~~~~Your output:~~enter the rows of matrix a :enter the columns of matrix a :enter the rows of matrix b :enter the columns of matrix b~~~~========= CODE CASES =========~~~~~~FAILED: Code Case 1:~~Correct structure definition to store 2D matrix~~  Mark/s obtained: 0 out of 10~~~~~~FAILED: Code Case 2:~~Creation of matrix~~  Mark/s obtained: 0 out of 10~~~~~~FAILED: Code Case 3:~~Read and print of matrix~~  Mark/s obtained: 0 out of 10~~~~~~FAILED: Code Case 4:~~Matrix multiplication logic~~  Mark/s obtained: 0 out of 20~~~~~~FAILED: Code Case 5:~~Correct Resultant matrix~~  Mark/s obtained: 0 out of 10~~~~~~==============================~~~~########## TOTAL MARKS OBTAINED = 0/80 ###########
22MT10012;0;0;0;0;0;0;0;0;========= TEST CASES =========~~~~~~FAILED: Code didn't compile successfully~~  Mark/s obtained: 0 out of 20~~~~~~========= CODE CASES =========~~~~~~FAILED: Code Case 1:~~Correct structure definition to store 2D matrix~~  Mark/s obtained: 0 out of 10~~~~~~FAILED: Code Case 2:~~Creation of matrix~~  Mark/s obtained: 0 out of 10~~~~~~FAILED: Code Case 3:~~Read and print of matrix~~  Mark/s obtained: 0 out of 10~~~~~~FAILED: Code Case 4:~~Matrix multiplication logic~~  Mark/s obtained: 0 out of 20~~~~~~FAILED: Code Case 5:~~Correct Resultant matrix~~  Mark/s obtained: 0 out of 10~~~~~~==============================~~~~########## TOTAL MARKS OBTAINED = 0/80 ###########
22MT10050;0;0;0;0;0;0;0;0;A file was not submitted properly ~~Mark/s lost: 80 out of 80~~~~~~==============================~~~~########## TOTAL MARKS OBTAINED = 0/80 ###########
22MT30005;0;0;0;0;0;0;0;0;A file was not submitted properly ~~Mark/s lost: 80 out of 80~~~~~~==============================~~~~########## TOTAL MARKS OBTAINED = 0/80 ###########
22MT30024;0;0;0;0;0;0;0;0;========= TEST CASES =========~~~~~~FAILED: Test Case 1: ~~INPUT:2 2 2 3~~~~2 3~~2 3~~~~1 2 3~~4 5 6~~Desired Output:~~~~Matrices before multiplication:~~Matrix A:~~2 3~~2 3~~Matrix B:~~1 2 3~~4 5 6~~Matrices after multiplication:~~Matrix A:~~2 3~~2 3~~Matrix B:~~1 2 3~~4 5 6~~Resultant Matrix:~~14 19 24~~14 19 24 ~~  Mark/s obtained: 0 out of 10~~~~~~Your output:~~~~~~FAILED: Test Case 2: ~~INPUT:2 3 2 3~~~~1 2 3~~1 1 1~~~~2 3 3~~1 1 1~~Desired Output:~~~~Matrices before multiplication:~~Matrix A:~~1 2 3~~1 1 1~~Matrix B:~~2 3 3~~1 1 1~~Error: Invalid matrix sizes for multiplication! ~~  Mark/s obtained: 0 out of 10~~~~~~Your output:~~~~~~========= CODE CASES =========~~~~~~FAILED: Code Case 1:~~Correct structure definition to store 2D matrix~~  Mark/s obtained: 0 out of 10~~~~~~FAILED: Code Case 2:~~Creation of matrix~~  Mark/s obtained: 0 out of 10~~~~~~FAILED: Code Case 3:~~Read and print of matrix~~  Mark/s obtained: 0 out of 10~~~~~~FAILED: Code Case 4:~~Matrix multiplication logic~~  Mark/s obtained: 0 out of 20~~~~~~FAILED: Code Case 5:~~Correct Resultant matrix~~  Mark/s obtained: 0 out of 10~~~~~~==============================~~~~########## TOTAL MARKS OBTAINED = 0/80 ###########
22NA10030;0;0;0;0;0;0;0;0;A file was not submitted properly ~~Mark/s lost: 80 out of 80~~~~~~==============================~~~~########## TOTAL MARKS OBTAINED = 0/80 ###########
22NA10049;4;10;10;10;10;18;0;62;========= TEST CASES =========~~~~~~FAILED: Test Case 1: ~~INPUT:2 2 2 3~~~~2 3~~2 3~~~~1 2 3~~4 5 6~~Desired Output:~~~~Matrices before multiplication:~~Matrix A:~~2 3~~2 3~~Matrix B:~~1 2 3~~4 5 6~~Matrices after multiplication:~~Matrix A:~~2 3~~2 3~~Matrix B:~~1 2 3~~4 5 6~~Resultant Matrix:~~14 19 24~~14 19 24 ~~  Mark/s obtained: 4 out of 10~~~~~~Your output:~~Enter the number of rows for matrix A:~~Enter the number of rows for matrix A:~~Enter the number of rows for matrix B:~~Enter the number of rows for matrix B:Enter the values for matrix A~~Enter the values for matrix B~~~~ Matrix a is ~~ 2 3 ~~ 2 3 ~~ ~~ Matrix b is ~~ 1 2 3 ~~ 4 5 6 ~~ ~~ Matrix c is ~~ 7799134 19 7799144 ~~ 7799134 19 7799144 ~~ ~~~~========= CODE CASES =========~~~~~~PASSED: Code Case 1:~~Correct structure definition to store 2D matrix~~  Mark/s obtained: 10 out of 10~~~~~~PASSED: Code Case 2:~~Creation of matrix~~  Mark/s obtained: 10 out of 10~~~~~~PASSED: Code Case 3:~~Read and print of matrix~~  Mark/s obtained: 10 out of 10~~~~~~FAILED: Code Case 4:~~Matrix multiplication logic~~  Mark/s obtained: 18 out of 20~~~~~~FAILED: Code Case 5:~~Correct Resultant matrix~~  Mark/s obtained: 0 out of 10~~~~~~==============================~~~~########## TOTAL MARKS OBTAINED = 62/80 ##########
22NA30019;0;0;0;0;0;0;0;0;========= TEST CASES =========~~~~~~FAILED: Code didn't compile successfully~~  Mark/s obtained: 0 out of 20~~~~~~========= CODE CASES =========~~~~~~FAILED: Code Case 1:~~Correct structure definition to store 2D matrix~~  Mark/s obtained: 0 out of 10~~~~~~FAILED: Code Case 2:~~Creation of matrix~~  Mark/s obtained: 0 out of 10~~~~~~FAILED: Code Case 3:~~Read and print of matrix~~  Mark/s obtained: 0 out of 10~~~~~~FAILED: Code Case 4:~~Matrix multiplication logic~~  Mark/s obtained: 0 out of 20~~~~~~FAILED: Code Case 5:~~Correct Resultant matrix~~  Mark/s obtained: 0 out of 10~~~~~~==============================~~~~########## TOTAL MARKS OBTAINED = 0/80 ###########
22PH10002;10;10;10;10;10;20;10;80;Good~~~~========= TEST CASES =========~~~~PASSED: All test cases - Marks : 20 out of 20~~~~========= CODE CASES =========~~~~~~PASSED: Code Case 1:~~Correct structure definition to store 2D matrix~~  Mark/s obtained: 10 out of 10~~~~~~PASSED: Code Case 2:~~Creation of matrix~~  Mark/s obtained: 10 out of 10~~~~~~PASSED: Code Case 3:~~Read and print of matrix~~  Mark/s obtained: 10 out of 10~~~~~~PASSED: Code Case 4:~~Matrix multiplication logic~~  Mark/s obtained: 20 out of 20~~~~~~PASSED: Code Case 5:~~Correct Resultant matrix~~  Mark/s obtained: 10 out of 10~~~~PASSED: All code cases - Marks : 60 out of 60~~~~==============================~~~~########## TOTAL MARKS OBTAINED = 80/80 ##########
22PH10021;0;0;0;0;0;0;0;0;A file was not submitted properly ~~Mark/s lost: 80 out of 80~~~~~~==============================~~~~########## TOTAL MARKS OBTAINED = 0/80 ###########
22PH10040;0;0;10;10;0;0;0;20;========= TEST CASES =========~~~~~~FAILED: Test Case 1: ~~INPUT:2 2 2 3~~~~2 3~~2 3~~~~1 2 3~~4 5 6~~Desired Output:~~~~Matrices before multiplication:~~Matrix A:~~2 3~~2 3~~Matrix B:~~1 2 3~~4 5 6~~Matrices after multiplication:~~Matrix A:~~2 3~~2 3~~Matrix B:~~1 2 3~~4 5 6~~Resultant Matrix:~~14 19 24~~14 19 24 ~~  Mark/s obtained: 0 out of 10~~~~~~Your output:~~[ERROR: SEGMENTATION_FAULT or RUNTIMEOUT.~~It may be due one of the following:~~+ Waits for more user input than expected/defined in the question or~~+ Code throws a math exception during runtime or~~+ Runs into an infinite loop or~~or something else completely, we will never know...~~]~~~~FAILED: Test Case 2: ~~INPUT:2 3 2 3~~~~1 2 3~~1 1 1~~~~2 3 3~~1 1 1~~Desired Output:~~~~Matrices before multiplication:~~Matrix A:~~1 2 3~~1 1 1~~Matrix B:~~2 3 3~~1 1 1~~Error: Invalid matrix sizes for multiplication! ~~  Mark/s obtained: 0 out of 10~~~~~~Your output:~~[ERROR: SEGMENTATION_FAULT or RUNTIMEOUT.~~It may be due one of the following:~~+ Waits for more user input than expected/defined in the question or~~+ Code throws a math exception during runtime or~~+ Runs into an infinite loop or~~or something else completely, we will never know...~~]~~~~========= CODE CASES =========~~~~~~PASSED: Code Case 1:~~Correct structure definition to store 2D matrix~~  Mark/s obtained: 10 out of 10~~~~~~PASSED: Code Case 2:~~Creation of matrix~~  Mark/s obtained: 10 out of 10~~~~~~FAILED: Code Case 3:~~Read and print of matrix~~  Mark/s obtained: 0 out of 10~~~~~~FAILED: Code Case 4:~~Matrix multiplication logic~~  Mark/s obtained: 0 out of 20~~~~~~FAILED: Code Case 5:~~Correct Resultant matrix~~  Mark/s obtained: 0 out of 10~~~~~~==============================~~~~########## TOTAL MARKS OBTAINED = 20/80 ##########
22EC10047;0;0;0;2;10;5;0;17;========= TEST CASES =========~~~~~~FAILED: Code didn't compile successfully~~  Mark/s obtained: 0 out of 20~~~~~~========= CODE CASES =========~~~~~~FAILED: Code Case 1:~~Correct structure definition to store 2D matrix~~  Mark/s obtained: 0 out of 10~~~~~~FAILED: Code Case 2:~~Creation of matrix~~  Mark/s obtained: 2 out of 10~~~~~~PASSED: Code Case 3:~~Read and print of matrix~~  Mark/s obtained: 10 out of 10~~~~~~FAILED: Code Case 4:~~Matrix multiplication logic~~  Mark/s obtained: 5 out of 20~~~~~~FAILED: Code Case 5:~~Correct Resultant matrix~~  Mark/s obtained: 0 out of 10~~~~~~==============================~~~~########## TOTAL MARKS OBTAINED = 17/80 ##########
22ME30069;0;0;10;10;10;0;0;30;========= TEST CASES =========~~~~~~FAILED: Code didn't compile successfully~~  Mark/s obtained: 0 out of 20~~~~~~========= CODE CASES =========~~~~~~PASSED: Code Case 1:~~Correct structure definition to store 2D matrix~~  Mark/s obtained: 10 out of 10~~~~~~PASSED: Code Case 2:~~Creation of matrix~~  Mark/s obtained: 10 out of 10~~~~~~PASSED: Code Case 3:~~Read and print of matrix~~  Mark/s obtained: 10 out of 10~~~~~~FAILED: Code Case 4:~~Matrix multiplication logic~~  Mark/s obtained: 0 out of 20~~~~~~FAILED: Code Case 5:~~Correct Resultant matrix~~  Mark/s obtained: 0 out of 10~~~~~~==============================~~~~########## TOTAL MARKS OBTAINED = 30/80 ##########
22NA10011;2;2;10;10;5;20;10;59;========= TEST CASES =========~~~~~~FAILED: Test Case 1: ~~INPUT:2 2 2 3~~~~2 3~~2 3~~~~1 2 3~~4 5 6~~Desired Output:~~~~Matrices before multiplication:~~Matrix A:~~2 3~~2 3~~Matrix B:~~1 2 3~~4 5 6~~Matrices after multiplication:~~Matrix A:~~2 3~~2 3~~Matrix B:~~1 2 3~~4 5 6~~Resultant Matrix:~~14 19 24~~14 19 24 ~~  Mark/s obtained: 2 out of 10~~~~~~Your output:~~Matrix A:-~~3	2	~~3	2	~~~~Matrix B:-~~3	1	~~2	3	~~~~Matrix C:-~~13	9	~~13	9	~~~~~~~~FAILED: Test Case 2: ~~INPUT:2 3 2 3~~~~1 2 3~~1 1 1~~~~2 3 3~~1 1 1~~Desired Output:~~~~Matrices before multiplication:~~Matrix A:~~1 2 3~~1 1 1~~Matrix B:~~2 3 3~~1 1 1~~Error: Invalid matrix sizes for multiplication! ~~  Mark/s obtained: 2 out of 10~~~~~~Your output:~~Matrix A:-~~3	1	2	~~3	1	1	~~~~Matrix B:-~~1	2	~~3	3	~~1	1	~~~~Matrix C:-~~8	11	~~7	10	~~~~~~~~========= CODE CASES =========~~~~~~PASSED: Code Case 1:~~Correct structure definition to store 2D matrix~~  Mark/s obtained: 10 out of 10~~~~~~PASSED: Code Case 2:~~Creation of matrix~~  Mark/s obtained: 10 out of 10~~~~~~FAILED: Code Case 3:~~Read and print of matrix~~  Mark/s obtained: 5 out of 10~~~~~~PASSED: Code Case 4:~~Matrix multiplication logic~~  Mark/s obtained: 20 out of 20~~~~~~PASSED: Code Case 5:~~Correct Resultant matrix~~  Mark/s obtained: 10 out of 10~~~~~~==============================~~~~########## TOTAL MARKS OBTAINED = 59/80 ##########
22GG10052;10;10;10;10;10;20;10;80;Good work~~~~========= TEST CASES =========~~~~PASSED: All test cases - Marks : 20 out of 20~~~~========= CODE CASES =========~~~~~~PASSED: Code Case 1:~~Correct structure definition to store 2D matrix~~  Mark/s obtained: 10 out of 10~~~~~~PASSED: Code Case 2:~~Creation of matrix~~  Mark/s obtained: 10 out of 10~~~~~~PASSED: Code Case 3:~~Read and print of matrix~~  Mark/s obtained: 10 out of 10~~~~~~PASSED: Code Case 4:~~Matrix multiplication logic~~  Mark/s obtained: 20 out of 20~~~~~~PASSED: Code Case 5:~~Correct Resultant matrix~~  Mark/s obtained: 10 out of 10~~~~PASSED: All code cases - Marks : 60 out of 60~~~~==============================~~~~########## TOTAL MARKS OBTAINED = 80/80 ##########
